Grapheme	IPA
aba	a β a
abba	a bː a
abraba	a β r a β a
abrjan	a β r j a n
abrs	a β r̥ s
ada	a ð a
addi	a dː ɪ
adrs	a ð r̥ s
ael	a e l
af	a ɸ
afagjan	a ɸ a ɣ j a n
afaikan	a ɸ ɛ k a n
afaírzjan	a ɸ ɛ r z j a n
afar	a ɸ a r
afara	a ɸ a r a
afardags	a ɸ a r d a ɣ s
afargaggan	a ɸ a r ɡ a ŋ ɡ a n
afarlaistjan	a ɸ a r l ɛ s t j a n
afarsabbate	a ɸ a r s a bː a t e
afaruþþan	a ɸ a r u θː a n
afblindnan	a ɸ b l ɪ n d n a n
afdailjan	a ɸ d ɛ l j a n
afdaubnan	a ɸ d ɔ β n a n
afdáuiþs	a ɸ d ɔ ɪ θ s
afdauþjan	a ɸ d ɔ θ j a n
afdōbnan	a ɸ d o β n a n
afdōjan	a ɸ d o j a n
afdōmeins	a ɸ d o m i n s
afdōmjan	a ɸ d o m j a n
afdrausjan	a ɸ d r ɔ s j a n
afdrugk	a ɸ d r u ŋ k
afdrugkja	a ɸ d r u ŋ k j a
afdumbnan	a ɸ d u m b n a n
afēt	a ɸ e t
afētja	a ɸ e t j a
afēts	a ɸ e t s
affilhan	a ɸː ɪ l h a n
afgaggan	a ɸ ɡ a ŋ ɡ a n
afgibansik	a ɸ ɡ ɪ β a n s ɪ k
afgrundiþa	a ɸ ɡ r u n d ɪ θ a
afgrundus	a ɸ ɡ r u n d u s
afgudei	a ɸ ɡ u ð i
afguþs	a ɸ ɡ u θ s
afhabansik	a ɸ h a β a n s ɪ k
afhaimeis	a ɸ h ɛ m i s
afhamōn	a ɸ h a m o n
afhlaþan	a ɸ h l a θ a n
afhōlōn	a ɸ h o l o n
afhrainjan	a ɸ h r ɛ n j a n
afhrisjan	a ɸ h r ɪ s j a n
afhugjan	a ɸ h u ɣ j a n
afƕapjan	a ɸ ʍ a p j a n
afƕapnan	a ɸ ʍ a p n a n
afitan	a ɸ ɪ t a n
aflageins	a ɸ l a ɣ i n s
aflagjan	a ɸ l a ɣ j a n
afleiþan	a ɸ l i θ a n
aflēt	a ɸ l e t
aflētan	a ɸ l e t a n
aflifnan	a ɸ l ɪ ɸ n a n
aflinnan	a ɸ l ɪ nː a n
afmaitan	a ɸ m ɛ t a n
afmarzeins	a ɸ m a r z i n s
afmarzjan	a ɸ m a r z j a n
afmáuiþs	a ɸ m ɔ ɪ θ s
afmōjan	a ɸ m o j a n
afniman	a ɸ n ɪ m a n
afqiþan	a ɸ kʷ ɪ θ a n
afsateins	a ɸ s a t i n s
afsatjan	a ɸ s a t j a n
afskaidan	a ɸ s k ɛ ð a n
afskiuban	a ɸ s k ɪ u β a n
afslahan	a ɸ s l a h a n
afslaupjan	a ɸ s l ɔ p j a n
afslauþjan	a ɸ s l ɔ θ j a n
afslauþnan	a ɸ s l ɔ θ n a n
afstandan	a ɸ s t a n d a n
afstass	a ɸ s t a sː
afswaggwjan	a ɸ s w a ɡ ɡ w j a n
afswaírban	a ɸ s w ɛ r b a n
afta	a ɸ t a
aftana	a ɸ t a n a
aftarō	a ɸ t a r o
aftaúrnan	a ɸ t ɔ r n a n
aftiuhan	a ɸ t ɪ u h a n
aftra	a ɸ t r a
aftraanastōdeins	a ɸ t r a a n a s t o ð i n s
aftuma	a ɸ t u m a
aftumists	a ɸ t u m ɪ s t s
afþaúrsjan	a ɸ θ ɔ r s j a n
afþliuhan	a ɸ θ l ɪ u h a n
afþwahan	a ɸ θ w a h a n
afwagjan	a ɸ w a ɣ j a n
afwaírpan	a ɸ w ɛ r p a n
afwalwjan	a ɸ w a l w j a n
afwandjan	a ɸ w a n d j a n
agan	a ɣ a n
agands	a ɣ a n d s
agatja	a ɣ a t j a
agei	a ɣ i
agga	a ŋ ɡ a
Aggils	a ŋ ɡ ɪ l s
aggilus	a ŋ ɡ ɪ l u s
aggwei	a ɡ ɡ w i
aggwiþa	a ɡ ɡ w ɪ θ a
aggwjan	a ɡ ɡ w j a n
aggwus	a ɡ ɡ w u s
agi	a ɣ ɪ
agis	a ɣ ɪ s
agjan	a ɣ j a n
agkja	a ŋ k j a
aglaitei	a ɣ l ɛ t i
aglaiteis	a ɣ l ɛ t i s
aglaitgastalds	a ɣ l ɛ t ɡ a s t a l d s
aglaiti	a ɣ l ɛ t ɪ
aglaitiwáurdei	a ɣ l ɛ t ɪ w ɔ r d i
aglaitiwáurds	a ɣ l ɛ t ɪ w ɔ r d s
agliþa	a ɣ l ɪ θ a
agljan	a ɣ l j a n
aglō	a ɣ l o
agls	a ɣ l̥ s
agluba	a ɣ l u β a
aglus	a ɣ l u s
agra	a ɣ r a
ags	a ɣ s
aha	a h a
ahaks	a h a k s
ahana	a h a n a
ahjan	a h j a n
ahma	a h m a
ahmateins	a h m a t i n s
ahmatjan	a h m a t j a n
ahmeins	a h m i n s
ahs	a h s
ahsa	a h s a
ahtau	a h t ɔ
ahtaudōgs	a h t ɔ ð o ɣ s
ahtautaihun	a h t ɔ t ɛ h u n
ahtautēhund	a h t ɔ t e h u n d
ahtuda	a h t u ð a
aƕa	a ʍ a
aids	ɛ ð s
aíffaþa	ɛ ɸː a θ a
aifrs	ɛ ɸ r̥ s
aigan	ɛ ɣ a n
aigin	ɛ ɣ ɪ n
aiginōn	ɛ ɣ ɪ n o n
aigins	ɛ ɣ ɪ n s
aihtr	ɛ h t r̥
aihtrōn	ɛ h t r o n
aihtrōns	ɛ h t r o n s
aihts	ɛ h t s
aíƕatundi	ɛ ʍ a t u n d ɪ
aíƕs	ɛ ʍ s
aikan	ɛ k a n
aíkklesjō	ɛ kː l e s j o
aiks	ɛ k s
aílōe	ɛ l o e
ainabaúr	ɛ n a β ɔ r
ainaha	ɛ n a h a
ainakls	ɛ n a k l̥ s
ainamundiþa	ɛ n a m u n d ɪ θ a
ainamunds	ɛ n a m u n d s
ainfalþaba	ɛ n ɸ a l θ a β a
ainfalþei	ɛ n ɸ a l θ i
ainfalþs	ɛ n ɸ a l θ s
ainƕarjizuh	ɛ n ʍ a r j ɪ z u h
ainƕaþaruh	ɛ n ʍ a θ a r u h
ainlif	ɛ n l ɪ ɸ
ains	ɛ n s
ainshun	ɛ n s h u n
aípiskaúpei	ɛ p ɪ s k ɔ p i
aípiskaúpus	ɛ p ɪ s k ɔ p u s
aípistaúle	ɛ p ɪ s t ɔ l e
air	ɛ r
airinōn	ɛ r ɪ n o n
airis	ɛ r ɪ s
airiza	ɛ r ɪ z a
aírknis	ɛ r k n ɪ s
aírkniþa	ɛ r k n ɪ θ a
aírkns	ɛ r k n̥ s
airmans	ɛ r m a n s
aírþa	ɛ r θ a
aírþakunds	ɛ r θ a k u n d s
aírþeins	ɛ r θ i n s
airus	ɛ r u s
aírzei	ɛ r z i
aírzeis	ɛ r z i s
aírziþa	ɛ r z ɪ θ a
aírzjan	ɛ r z j a n
aiskōn	ɛ s k o n
aistan	ɛ s t a n
aiþei	ɛ θ i
aiþs	ɛ θ s
aíþþau	ɛ θː ɔ
aiw	ɛ w
aíwaggēli	ɛ w a ŋ ɡ e l ɪ
aíwaggēlista	ɛ w a ŋ ɡ e l ɪ s t a
aíwaggēljan	ɛ w a ŋ ɡ e l j a n
aíwaggēljō	ɛ w a ŋ ɡ e l j o
aiweins	ɛ w i n s
aiwiski	ɛ w ɪ s k ɪ
aiwiskōn	ɛ w ɪ s k o n
aiwisks	ɛ w ɪ s k s
aíwlaúgia	ɛ w l ɔ ɣ ɪ a
aiws	ɛ w s
aíwxaristia	ɛ w χ a r ɪ s t ɪ a
aiz	ɛ z
aiza	ɛ z a
aizasmiþa	ɛ z a s m ɪ θ a
ajukdūþs	a j u k d u θ s
ajuks	a j u k s
ak	a k
akan	a k a n
akei	a k i
akēt	a k e t
akran	a k r a n
akranalaus	a k r a n a l ɔ s
akrs	a k r̥ s
ala	a l a
alabalstraún	a l a β a l s t r ɔ n
alabrunsts	a l a β r u n s t s
alakjis	a l a k j ɪ s
alakjō	a l a k j o
alamans	a l a m a n s
alan	a l a n
alaþarba	a l a θ a r b a
alauds	a l ɔ ð s
albs	a l b s
alda	a l d a
aldōmō	a l d o m o
aldr	a l d r̥
alds	a l d s
alduma	a l d u m a
aleina	a l i n a
alēw	a l e w
alēwabagms	a l e w a β a ɣ m̥ s
alēwja	a l e w j a
alh	a l h
alhs	a l h s
ali	a l ɪ
alisi	a l ɪ s ɪ
alisna	a l ɪ s n a
alisō	a l ɪ s o
aliþs	a l ɪ θ s
aliza	a l ɪ z a
alja	a l j a
aljakuns	a l j a k u n s
aljaleikō	a l j a l i k o
aljaleikōþs	a l j a l i k o θ s
aljaleiks	a l j a l i k s
aljan	a l j a n
aljanōn	a l j a n o n
aljar	a l j a r
aljaþ	a l j a θ
aljaþrō	a l j a θ r o
aljis	a l j ɪ s
allandjis	a lː a n d j ɪ s
allandjō	a lː a n d j o
allaþrō	a lː a θ r o
allawaúrstwa	a lː a w ɔ r s t w a
allawērei	a lː a w e r i
allawēreis	a lː a w e r i s
allis	a lː ɪ s
alls	a lː s
allwaldands	a lː w a l d a n d s
alþan	a l θ a n
alþeis	a l θ i s
amals	a m a l s
amen	a m e n
ams	a m s
an	a n
ana	a n a
anaaukan	a n a ɔ k a n
anabiudan	a n a β ɪ u ð a n
anabūsns	a n a β u s n̥ s
anadrigkan	a n a ð r ɪ ŋ k a n
anafilh	a n a ɸ ɪ l h
anafilhan	a n a ɸ ɪ l h a n
anagaggan	a n a ɣ a ŋ ɡ a n
anahaban	a n a h a β a n
anahaimeis	a n a h ɛ m i s
anahaitan	a n a h ɛ t a n
anahamōn	a n a h a m o n
anahaspan	a n a h a s p a n
anahnaiwjan	a n a h n ɛ w j a n
anahneiwan	a n a h n i w a n
anaƕeilan	a n a ʍ i l a n
anainsakan	a n ɛ n s a k a n
anakaúrjan	a n a k ɔ r j a n
anaks	a n a k s
anakumbjan	a n a k u m b j a n
anakunnains	a n a k u nː ɛ n s
anakunnan	a n a k u nː a n
analageins	a n a l a ɣ i n s
analagjan	a n a l a ɣ j a n
analatjan	a n a l a t j a n
analaugnei	a n a l ɔ ɣ n i
analaugniba	a n a l ɔ ɣ n ɪ β a
analaugns	a n a l ɔ ɣ n̥ s
analeikō	a n a l i k o
analeiks	a n a l i k s
anamahtjan	a n a m a h t j a n
anamahts	a n a m a h t s
anamēljan	a n a m e l j a n
anaminds	a n a m ɪ n d s
anan	a n a n
ananamnjan	a n a n a m n j a n
anananþjan	a n a n a n θ j a n
ananauþjan	a n a n ɔ θ j a n
ananiujan	a n a n ɪ u j a n
ananiujiþa	a n a n ɪ u j ɪ θ a
anapraggan	a n a p r a ŋ ɡ a n
anaqal	a n a kʷ a l
anaqilan	a n a kʷ ɪ l a n
anaqiman	a n a kʷ ɪ m a n
anaqiss	a n a kʷ ɪ sː
anaqiþan	a n a kʷ ɪ θ a n
anaqiujan	a n a kʷ ɪ u j a n
anasilan	a n a s ɪ l a n
anasiuniba	a n a s ɪ u n ɪ β a
anasiuns	a n a s ɪ u n s
anaslawan	a n a s l a w a n
anaslēpan	a n a s l e p a n
anastōdeins	a n a s t o ð i n s
anastōdjan	a n a s t o ð j a n
anatimrjan	a n a t ɪ m r j a n
anatjan	a n a t j a n
anatrimpan	a n a t r ɪ m p a n
anaþaíma	a n a θ ɛ m a
anaþiwan	a n a θ ɪ w a n
anaþrafstjan	a n a θ r a ɸ s t j a n
anawaírþs	a n a w ɛ r θ s
anawammjan	a n a w a mː j a n
anawiljei	a n a w ɪ l j i
anawiljis	a n a w ɪ l j ɪ s
and	a n d
anda	a n d a
andabaúhts	a n d a β ɔ h t s
andabeit	a n d a β i t
andahafts	a n d a h a ɸ t s
andahait	a n d a h ɛ t
andalauni	a n d a l ɔ n ɪ
andanahti	a n d a n a h t ɪ
andaneiþa	a n d a n i θ a
andaneiþs	a n d a n i θ s
andanēm	a n d a n e m
andanēmeigs	a n d a n e m i ɣ s
andanēms	a n d a n e m s
andanumts	a n d a n u m t s
andasēts	a n d a s e t s
andastaþjis	a n d a s t a θ j ɪ s
andastaua	a n d a s t ɔ a
andaþāhts	a n d a θ a h t s
andaugi	a n d ɔ ɣ ɪ
andaugiba	a n d ɔ ɣ ɪ β a
andaugjō	a n d ɔ ɣ j o
andawaírþi	a n d a w ɛ r θ ɪ
andawaúrdi	a n d a w ɔ r d ɪ
andawizns	a n d a w ɪ z n̥ s
andawleizn	a n d a w l i z n̥
andawliti	a n d a w l ɪ t ɪ
andbahti	a n d b a h t ɪ
andbahtjan	a n d b a h t j a n
andbahts	a n d b a h t s
andbeitan	a n d b i t a n
andbindan	a n d b ɪ n d a n
andbundnan	a n d b u n d n a n
andeis	a n d i s
andhafjan	a n d h a ɸ j a n
andhaitan	a n d h ɛ t a n
andhamōnsik	a n d h a m o n s ɪ k
andhausjan	a n d h ɔ s j a n
andhruskan	a n d h r u s k a n
andhuleins	a n d h u l i n s
andhuliþs	a n d h u l ɪ θ s
andhuljan	a n d h u l j a n
andi	a n d ɪ
andilaus	a n d ɪ l ɔ s
andizuh	a n d ɪ z u h
andjan	a n d j a n
andlētan	a n d l e t a n
andlētnan	a n d l e t n a n
andniman	a n d n ɪ m a n
andqiþan	a n d kʷ ɪ θ a n
andrinnan	a n d r ɪ nː a n
andsaíƕan	a n d s ɛ ʍ a n
andsakan	a n d s a k a n
andsakans	a n d s a k a n s
andsaljan	a n d s a l j a n
andsitan	a n d s ɪ t a n
andsōks	a n d s o k s
andspeiwan	a n d s p i w a n
andstald	a n d s t a l d
andstaldan	a n d s t a l d a n
andstandan	a n d s t a n d a n
andstaúrran	a n d s t ɔ rː a n
andtilōn	a n d t ɪ l o n
andþagkjansik	a n d θ a ŋ k j a n s ɪ k
andwaírþi	a n d w ɛ r θ ɪ
andwaírþis	a n d w ɛ r θ ɪ s
andwaírþō	a n d w ɛ r θ o
andwaírþs	a n d w ɛ r θ s
andwasjan	a n d w a s j a n
andwaúrdjan	a n d w ɔ r d j a n
andweihan	a n d w i h a n
anetiare	a n e t ɪ a r e
annō	a nː o
ans	a n s
anses	a n s e s
ansteigs	a n s t i ɣ s
ansts	a n s t s
ansula	a n s u l a
ansus	a n s u s
ant	a n t
anþar	a n θ a r
anþarleikei	a n θ a r l i k i
anþarleikō	a n θ a r l i k o
anþarleiks	a n θ a r l i k s
anþs	a n θ s
apaústaúlei	a p ɔ s t ɔ l i
apaústaúlus	a p ɔ s t ɔ l u s
apls	a p l̥ s
aqizi	a kʷ ɪ z ɪ
ara	a r a
Arabia	a r a β ɪ a
arbaidjan	a r b ɛ ð j a n
arbaiþs	a r b ɛ θ s
arbi	a r b ɪ
arbinumja	a r b ɪ n u m j a
arbja	a r b j a
arbjō	a r b j o
arca	a r c a
areinsdags	a r i n s d a ɣ s
arga	a r ɡ a
args	a r ɡ s
arh	a r h
arha	a r h a
arƕa	a r ʍ a
arƕazna	a r ʍ a z n a
arjan	a r j a n
arjausdags	a r j ɔ s d a ɣ s
arka	a r k a
arkaggilus	a r k a ŋ ɡ ɪ l u s
armahaírtei	a r m a h ɛ r t i
armahaírtiþa	a r m a h ɛ r t ɪ θ a
armahaírts	a r m a h ɛ r t s
armaiō	a r m ɛ o
arman	a r m a n
arms	a r m̥ s
arneis	a r n i s
arniba	a r n ɪ β a
arōmata	a r o m a t a
arþ	a r θ
arus	a r u s
arwjō	a r w j o
asans	a s a n s
Asia	a s ɪ a
asiluqaírnus	a s ɪ l u kʷ ɛ r n u s
asilus	a s ɪ l u s
aska	a s k a
asks	a s k s
asneis	a s n i s
asnō	a s n o
aspa	a s p a
assarjus	a sː a r j u s
astaþ	a s t a θ
asts	a s t s
at	a t
ataþni	a t a θ n ɪ
ataugjan	a t ɔ ɣ j a n
atbaíran	a t b ɛ r a n
atdragan	a t d r a ɣ a n
atdriusan	a t d r ɪ u s a n
atfarjan	a t ɸ a r j a n
atgagg	a t ɡ a ŋ ɡ
atgaggan	a t ɡ a ŋ ɡ a n
atgāhts	a t ɡ a h t s
atgaraíhtjan	a t ɡ a r ɛ h t j a n
atgiban	a t ɡ ɪ β a n
athabansikdu	a t h a β a n s ɪ k d u
athafjan	a t h a ɸ j a n
athāhan	a t h a h a n
athaitan	a t h ɛ t a n
atisk	a t ɪ s k
atjan	a t j a n
atkunnan	a t k u nː a n
atlagjan	a t l a ɣ j a n
atlaþōn	a t l a θ o n
atlēweins	a t l e w i n s
atlēweis	a t l e w i s
atligan	a t l ɪ ɣ a n
atnēƕjan	a t n e ʍ j a n
atniman	a t n ɪ m a n
atochta	a t o c h t a
atrinnan	a t r ɪ nː a n
atsaíƕan	a t s ɛ ʍ a n
atsatjan	a t s a t j a n
atsnarpjan	a t s n a r p j a n
atsniwan	a t s n ɪ w a n
atstandan	a t s t a n d a n
atsteigan	a t s t i ɣ a n
atta	a tː a
attēkan	a tː e k a n
attiuhan	a tː ɪ u h a n
atþinsan	a t θ ɪ n s a n
atugs	a t u ɣ s
atwaírpan	a t w ɛ r p a n
atwalwjan	a t w a l w j a n
atwandjan	a t w a n d j a n
atwisan	a t w ɪ s a n
atwitains	a t w ɪ t ɛ n s
atwitan	a t w ɪ t a n
atwōpjan	a t w o p j a n
aþal	a θ a l
aþals	a θ a l s
aþans	a θ a n s
aþn	a θ n̥
aþþan	a θː a n
audagei	ɔ ð a ɣ i
audagjan	ɔ ð a ɣ j a n
audags	ɔ ð a ɣ s
audahafts	ɔ ð a h a ɸ t s
audsauþs	ɔ ð s ɔ θ s
aúftō	ɔ ɸ t o
augadaúrō	ɔ ɣ a ð ɔ r o
augjan	ɔ ɣ j a n
augō	ɔ ɣ o
áuhjōdus	ɔ h j o ð u s
auhjōn	ɔ h j o n
aúhns	ɔ h n̥ s
aúhsa	ɔ h s a
aúhsus	ɔ h s u s
aúhuma	ɔ h u m a
auja	ɔ j a
auk	ɔ k
aukan	ɔ k a n
auknan	ɔ k n a n
aur	ɔ r
aurahi	ɔ r a h ɪ
aurahs	ɔ r a h s
aúrāli	ɔ r a l ɪ
aúrkeis	ɔ r k i s
aúrtigards	ɔ r t ɪ ɣ a r d s
aúrtja	ɔ r t j a
aúrts	ɔ r t s
aus	ɔ s
ausahriggs	ɔ s a h r ɪ ŋ ɡ s
ausō	ɔ s o
austra	ɔ s t r a
Austrogoti	ɔ s t r o ɣ o t ɪ
auþeis	ɔ θ i s
auþida	ɔ θ ɪ ð a
awa	a w a
awēþi	a w e θ ɪ
awi	a w ɪ
awiliudōn	a w ɪ l ɪ u ð o n
awiliuþ	a w ɪ l ɪ u θ
awistr	a w ɪ s t r̥
awō	a w o
aza	a z a
azētaba	a z e t a β a
azēti	a z e t ɪ
azēts	a z e t s
azgō	a z ɡ o
azwmus	a z w m u s
ba	b a
badi	b a ð ɪ
badu	b a ð u
baggwiþa	b a ɡ ɡ w ɪ θ a
bagks	b a ŋ k s
bagms	b a ɣ m̥ s
bai	b ɛ
baidjan	b ɛ ð j a n
baira	b ɛ r a
baírabagms	b ɛ r a β a ɣ m̥ s
baíran	b ɛ r a n
baírga	b ɛ r ɡ a
baírgahei	b ɛ r ɡ a h i
baírgahs	b ɛ r ɡ a h s
baírgan	b ɛ r ɡ a n
bairgō	b ɛ r ɡ o
baírgs	b ɛ r ɡ s
baírhtaba	b ɛ r h t a β a
baírhtei	b ɛ r h t i
baírhteins	b ɛ r h t i n s
baírhtjan	b ɛ r h t j a n
baírhts	b ɛ r h t s
baírka	b ɛ r k a
baitraba	b ɛ t r a β a
baitrei	b ɛ t r i
baitrs	b ɛ t r̥ s
bajōþs	b a j o θ s
bala	b a l a
balgbrust	b a l ɡ b r u s t
balgs	b a l ɡ s
bals	b a l s
balsan	b a l s a n
balþaba	b a l θ a β a
balþei	b a l θ i
balþjan	b a l θ j a n
balþs	b a l θ s
balu	b a l u
balus	b a l u s
balwaweis	b a l w a w i s
balwawēsei	b a l w a w e s i
balweins	b a l w i n s
balwjan	b a l w j a n
bandi	b a n d ɪ
bandja	b a n d j a
bandwa	b a n d w a
bandwjan	b a n d w j a n
bandwō	b a n d w o
banja	b a n j a
bannwīda	b a nː w i ð a
bansts	b a n s t s
bara	b a r a
barbarus	b a r b a r u s
bards	b a r d s
baris	b a r ɪ s
barizeins	b a r ɪ z i n s
barms	b a r m̥ s
barn	b a r n̥
barnahs	b a r n a h s
barnilō	b a r n ɪ l o
barniskei	b a r n ɪ s k i
barniski	b a r n ɪ s k ɪ
barnisks	b a r n ɪ s k s
barsiks	b a r s ɪ k s
barusnjan	b a r u s n j a n
bas	b a s
basi	b a s ɪ
bata	b a t a
batis	b a t ɪ s
batiza	b a t ɪ z a
batnan	b a t n a n
báuains	b ɔ ɛ n s
báuan	b ɔ a n
baudes	b ɔ ð e s
baugjan	b ɔ ɣ j a n
baugs	b ɔ ɣ s
bauljan	b ɔ l j a n
bauljō	b ɔ l j o
baúr	b ɔ r
baúrans	b ɔ r a n s
baúrd	b ɔ r d
baúrgja	b ɔ r ɡ j a
baúrgjan	b ɔ r ɡ j a n
baúrgs	b ɔ r ɡ s
baúrgswaddjus	b ɔ r ɡ s w a dː j u s
baúrjōþus	b ɔ r j o θ u s
baurs	b ɔ r s
baúrsti	b ɔ r s t ɪ
baurtils	b ɔ r t ɪ l s
baúrþei	b ɔ r θ i
baúrþs	b ɔ r θ s
bausei	b ɔ s i
bautan	b ɔ t a n
bauþs	b ɔ θ s
bawiþa	b a w ɪ θ a
bazjan	b a z j a n
bēga	b e ɣ a
beidan	b i ð a n
beist	b i s t
beistei	b i s t i
beistjan	b i s t j a n
beistjōþs	b i s t j o θ s
beitan	b i t a n
bel	b e l
belagines	b e l a ɣ ɪ n e s
bercna	b e r c n a
bērs	b e r s
bērusi	b e r u s ɪ
bērusjōs	b e r u s j o s
bi	b ɪ
biabrjan	b ɪ a β r j a n
biarbaidjan	b ɪ a r b ɛ ð j a n
biaukan	b ɪ ɔ k a n
biauknan	b ɪ ɔ k n a n
bibaúrgeins	b ɪ β ɔ r ɡ i n s
bibaúrgjan	b ɪ β ɔ r ɡ j a n
bibindan	b ɪ β ɪ n d a n
bida	b ɪ ð a
bidagwa	b ɪ ð a ɣ w a
bidan	b ɪ ð a n
bidjan	b ɪ ð j a n
bidōmjan	b ɪ ð o m j a n
bifaih	b ɪ ɸ ɛ h
bifaihōn	b ɪ ɸ ɛ h o n
bifaihōns	b ɪ ɸ ɛ h o n s
bigaírdan	b ɪ ɣ ɛ r d a n
bigardio	b ɪ ɣ a r d ɪ o
bigitan	b ɪ ɣ ɪ t a n
bigraban	b ɪ ɣ r a β a n
bihait	b ɪ h ɛ t
bihaitan	b ɪ h ɛ t a n
bihaitja	b ɪ h ɛ t j a
bihlahjan	b ɪ h l a h j a n
biƕaírban	b ɪ ʍ ɛ r b a n
biƕē	b ɪ ʍ e
bijandzuþþan	b ɪ j a n d z u θː a n
bikukjan	b ɪ k u k j a n
bilageins	b ɪ l a ɣ i n s
bilagjan	b ɪ l a ɣ j a n
bilaibjan	b ɪ l ɛ β j a n
bilaif	b ɪ l ɛ ɸ
bilaigōn	b ɪ l ɛ ɣ o n
bilaikan	b ɪ l ɛ k a n
bilaistiþs	b ɪ l ɛ s t ɪ θ s
bileiban	b ɪ l i β a n
bileiþan	b ɪ l i θ a n
bilgan	b ɪ l ɡ a n
bilisa	b ɪ l ɪ s a
bimait	b ɪ m ɛ t
bimaitan	b ɪ m ɛ t a n
bimampjan	b ɪ m a m p j a n
binaúhan	b ɪ n ɔ h a n
binda	b ɪ n d a
bindan	b ɪ n d a n
biniman	b ɪ n ɪ m a n
biniuhsjan	b ɪ n ɪ u h s j a n
biqiman	b ɪ kʷ ɪ m a n
biraubōn	b ɪ r ɔ β o n
bireikei	b ɪ r i k i
bireikeis	b ɪ r i k i s
birinnan	b ɪ r ɪ nː a n
birōdeins	b ɪ r o ð i n s
birōdjan	b ɪ r o ð j a n
birūnains	b ɪ r u n ɛ n s
birūnan	b ɪ r u n a n
bisaíƕan	b ɪ s ɛ ʍ a n
bisatjan	b ɪ s a t j a n
bisauleins	b ɪ s ɔ l i n s
bisauljan	b ɪ s ɔ l j a n
bisaulnan	b ɪ s ɔ l n a n
bisitan	b ɪ s ɪ t a n
biskaban	b ɪ s k a β a n
biskeinan	b ɪ s k i n a n
bismeitan	b ɪ s m i t a n
bisniwan	b ɪ s n ɪ w a n
bispeiwan	b ɪ s p i w a n
bistandan	b ɪ s t a n d a n
bistigqan	b ɪ s t ɪ ŋ kʷ a n
bistugq	b ɪ s t u ŋ kʷ
bisunjanē	b ɪ s u n j a n e
bisuus	b ɪ s u u s
biswaírban	b ɪ s w ɛ r b a n
biswaran	b ɪ s w a r a n
bitiuhan	b ɪ t ɪ u h a n
biþagkjan	b ɪ θ a ŋ k j a n
biþē	b ɪ θ e
biþragjan	b ɪ θ r a ɣ j a n
biþwahan	b ɪ θ w a h a n
biudan	b ɪ u ð a n
biugan	b ɪ u ɣ a n
biūhti	b ɪ u h t ɪ
biūhts	b ɪ u h t s
biuþs	b ɪ u θ s
biwaibjan	b ɪ w ɛ β j a n
biwandjan	b ɪ w a n d j a n
biwindan	b ɪ w ɪ n d a n
biwisan	b ɪ w ɪ s a n
blagks	b l a ŋ k s
blandansik	b l a n d a n s ɪ k
blas	b l a s
blauts	b l ɔ t s
blauþjan	b l ɔ θ j a n
blauþs	b l ɔ θ s
bleis	b l i s
bleiþei	b l i θ i
bleiþeins	b l i θ i n s
bleiþjan	b l i θ j a n
bleiþs	b l i θ s
blēsan	b l e s a n
blēsi	b l e s ɪ
blēsjan	b l e s j a n
blēstjan	b l e s t j a n
blēsts	b l e s t s
bliggwan	b l ɪ ɡ ɡ w a n
blindjan	b l ɪ n d j a n
blindnan	b l ɪ n d n a n
blinds	b l ɪ n d s
blōma	b l o m a
blōstr	b l o s t r̥
blōstreis	b l o s t r i s
blōtan	b l o t a n
blōteins	b l o t i n s
blōtinassus	b l o t ɪ n a sː u s
blōþ	b l o θ
blōþarinnands	b l o θ a r ɪ nː a n d s
blunds	b l u n d s
bnáuan	b n ɔ a n
boga	b o ɣ a
bōka	b o k a
bōkāreis	b o k a r i s
bōta	b o t a
bōtjan	b o t j a n
braƕ	b r a ʍ
braidei	b r ɛ ð i
braidjan	b r ɛ ð j a n
braiƕan	b r ɛ ʍ a n
braiþs	b r ɛ θ s
brakja	b r a k j a
bramjan	b r a m j a n
brammōn	b r a mː o n
branda	b r a n d a
brands	b r a n d s
brannjan	b r a nː j a n
brasa	b r a s a
brasōn	b r a s o n
brauþ	b r ɔ θ
breen	b r e e n
breuwan	b r e u w a n
bridila	b r ɪ ð ɪ l a
brigdil	b r ɪ ɣ d ɪ l
briggan	b r ɪ ŋ ɡ a n
brikan	b r ɪ k a n
brinnan	b r ɪ nː a n
brinnō	b r ɪ nː o
bristan	b r ɪ s t a n
briþ	b r ɪ θ
broe	b r o e
brōjan	b r o j a n
broks	b r o k s
brōþar	b r o θ a r
brōþrahans	b r o θ r a h a n s
brōþrahs	b r o θ r a h s
brōþrulubō	b r o θ r u l u β o
brugdjan	b r u ɣ d j a n
bruka	b r u k a
brukja	b r u k j a
brūkjan	b r u k j a n
bruknan	b r u k n a n
brūks	b r u k s
brunjō	b r u n j o
brunna	b r u nː a
brūns	b r u n s
brunsts	b r u n s t s
brust	b r u s t
brusti	b r u s t ɪ
brustjan	b r u s t j a n
brusts	b r u s t s
brutilō	b r u t ɪ l o
brutōn	b r u t o n
bruts	b r u t s
bruþ	b r u θ
brūþfaþs	b r u θ ɸ a θ s
brūþs	b r u θ s
bruzdōn	b r u z d o n
buggja	b u ŋ ɡ j a
bugjan	b u ɣ j a n
būks	b u k s
Bulgar	b u l ɡ a r
bundnan	b u n d n a n
būrjō	b u r j o
būska	b u s k a
būsns	b u s n̥ s
bwssaún	b w sː ɔ n
cadariou	c a ð a r ɪ o u
contropare	c o n t r o p a r e
contropatio	c o n t r o p a t ɪ o
criten	c r ɪ t e n
daban	d a β a n
daddjan	d a dː j a n
dagis	d a ɣ ɪ s
dags	d a ɣ s
daigs	d ɛ ɣ s
daila	d ɛ l a
dailjan	d ɛ l j a n
dails	d ɛ l s
daimōnāreis	d ɛ m o n a r i s
dalaþ	d a l a θ
dalaþa	d a l a θ a
dalaþrō	d a l a θ r o
dals	d a l s
dammjan	d a mː j a n
damms	d a mː s
Danila	d a n ɪ l a
Dans	d a n s
Danus	d a n u s
darnjan	d a r n j a n
darns	d a r n̥ s
daubei	d ɔ β i
daubiþa	d ɔ β ɪ θ a
daubjan	d ɔ β j a n
daubnan	d ɔ β n a n
daufs	d ɔ ɸ s
daúhtar	d ɔ h t a r
daúhts	d ɔ h t s
dauka	d ɔ k a
dauns	d ɔ n s
daupeins	d ɔ p i n s
daupjan	d ɔ p j a n
daupjands	d ɔ p j a n d s
daúr	d ɔ r
daúrawarda	d ɔ r a w a r d a
daúrawardō	d ɔ r a w a r d o
daúrawards	d ɔ r a w a r d s
daúri	d ɔ r ɪ
daúrō	d ɔ r o
daúrsan	d ɔ r s a n
dauþeins	d ɔ θ i n s
dauþjan	d ɔ θ j a n
dauþnan	d ɔ θ n a n
dauþs	d ɔ θ s
dauþubleis	d ɔ θ u β l i s
dauþus	d ɔ θ u s
dēdja	d e ð j a
deinō	d i n o
deis	d i s
deisei	d i s i
dēþs	d e θ s
diabaúlus	d ɪ a β ɔ l u s
diabula	d ɪ a β u l a
diakaúnus	d ɪ a k ɔ n u s
digan	d ɪ ɣ a n
digrei	d ɪ ɣ r i
digrs	d ɪ ɣ r̥ s
dis	d ɪ s
disdailjan	d ɪ s d ɛ l j a n
disdriusan	d ɪ s d r ɪ u s a n
dishaban	d ɪ s h a β a n
dishniupan	d ɪ s h n ɪ u p a n
dishnupnan	d ɪ s h n u p n a n
dishuljan	d ɪ s h u l j a n
disks	d ɪ s k s
disniman	d ɪ s n ɪ m a n
dissigqan	d ɪ sː ɪ ŋ kʷ a n
dissitan	d ɪ sː ɪ t a n
disskaidan	d ɪ sː k ɛ ð a n
disskreitan	d ɪ sː k r i t a n
disskritnan	d ɪ sː k r ɪ t n a n
distaheins	d ɪ s t a h i n s
distahjan	d ɪ s t a h j a n
distaíran	d ɪ s t ɛ r a n
distaúrnan	d ɪ s t ɔ r n a n
diswidan	d ɪ s w ɪ ð a n
diswilwan	d ɪ s w ɪ l w a n
diswinþjan	d ɪ s w ɪ n θ j a n
diswiss	d ɪ s w ɪ sː
diupei	d ɪ u p i
diupiþa	d ɪ u p ɪ θ a
diupjan	d ɪ u p j a n
diups	d ɪ u p s
dius	d ɪ u s
diwan	d ɪ w a n
diwanei	d ɪ w a n i
dōbnan	d o β n a n
dōfs	d o ɸ s
dōgs	d o ɣ s
dōmeins	d o m i n s
dōmjan	d o m j a n
dōms	d o m s
draban	d r a β a n
dragan	d r a ɣ a n
dragk	d r a ŋ k
dragkjan	d r a ŋ k j a n
draibjan	d r ɛ β j a n
drakma	d r a k m a
draúhsna	d r ɔ h s n a
draúhtinassus	d r ɔ h t ɪ n a sː u s
draúhtinōn	d r ɔ h t ɪ n o n
draúhtins	d r ɔ h t ɪ n s
draúhtiwitōþ	d r ɔ h t ɪ w ɪ t o θ
draúhts	d r ɔ h t s
drausjan	d r ɔ s j a n
dreiban	d r i β a n
drigkan	d r ɪ ŋ k a n
driugan	d r ɪ u ɣ a n
driusan	d r ɪ u s a n
driusō	d r ɪ u s o
drōbjan	d r o β j a n
drōbjis	d r o β j ɪ s
drōbna	d r o β n a
drōbnan	d r o β n a n
drugkanei	d r u ŋ k a n i
drugkja	d r u ŋ k j a
drugks	d r u ŋ k s
drunjus	d r u n j u s
drus	d r u s
drūþs	d r u θ s
du	d u
duatgaggan	d u a t ɡ a ŋ ɡ a n
duatrinnan	d u a t r ɪ nː a n
duatsniwan	d u a t s n ɪ w a n
dūbō	d u β o
dugan	d u ɣ a n
dugawindansik	d u ɣ a w ɪ n d a n s ɪ k
duginnan	d u ɣ ɪ nː a n
duƕē	d u ʍ e
dulgahaitja	d u l ɡ a h ɛ t j a
dulgs	d u l ɡ s
dulþjan	d u l θ j a n
dulþs	d u l θ s
dumbnan	d u m b n a n
dumbs	d u m b s
durinnan	d u r ɪ nː a n
dustōdjan	d u s t o ð j a n
dūþē	d u θ e
dwalawaúrdei	d w a l a w ɔ r d i
dwalawaúrds	d w a l a w ɔ r d s
dwaligōn	d w a l ɪ ɣ o n
dwaliþa	d w a l ɪ θ a
dwalmōn	d w a l m o n
dwalms	d w a l m̥ s
dwals	d w a l s
dwilan	d w ɪ l a n
ei	i
eigs	i ɣ s
eis	i s
eisarn	i s a r n̥
eisarnabandi	i s a r n a β a n d ɪ
eisarneins	i s a r n i n s
eiþan	i θ a n
ela	e l a
ēmaitja	e m ɛ t j a
enguz	e n ɡ u z
era	e r a
erls	e r l̥ s
ēt	e t
ēta	e t a
ētja	e t j a
ēts	e t s
eyz	e j z
ezec	e z e c
fadar	ɸ a ð a r
fadrein	ɸ a ð r i n
fadreins	ɸ a ð r i n s
faginōn	ɸ a ɣ ɪ n o n
fagins	ɸ a ɣ ɪ n s
fagrs	ɸ a ɣ r̥ s
fāh	ɸ a h
fāhan	ɸ a h a n
fahēþs	ɸ a h e θ s
fahrjan	ɸ a h r j a n
fahs	ɸ a h s
fáian	ɸ ɛ a n
faihan	ɸ ɛ h a n
faihs	ɸ ɛ h s
faíhu	ɸ ɛ h u
faíhufrikei	ɸ ɛ h u ɸ r ɪ k i
faíhufriks	ɸ ɛ h u ɸ r ɪ k s
faíhugaírnei	ɸ ɛ h u ɣ ɛ r n i
faíhugaírns	ɸ ɛ h u ɣ ɛ r n̥ s
faíhugawaúrki	ɸ ɛ h u ɣ a w ɔ r k ɪ
faíhugeigan	ɸ ɛ h u ɣ i ɣ a n
faíhugeirō	ɸ ɛ h u ɣ i r o
faíhugeirs	ɸ ɛ h u ɣ i r s
faíhuskula	ɸ ɛ h u s k u l a
faíhuþraihn	ɸ ɛ h u θ r ɛ h n̥
faír	ɸ ɛ r
faíraihan	ɸ ɛ r ɛ h a n
faírgreipan	ɸ ɛ r ɡ r i p a n
faírguni	ɸ ɛ r ɡ u n ɪ
faírhaitan	ɸ ɛ r h ɛ t a n
faírƕus	ɸ ɛ r ʍ u s
faírina	ɸ ɛ r ɪ n a
faírinōdaba	ɸ ɛ r ɪ n o ð a β a
faírinōn	ɸ ɛ r ɪ n o n
faírinōþs	ɸ ɛ r ɪ n o θ s
faírins	ɸ ɛ r ɪ n s
faírjan	ɸ ɛ r j a n
faírlaistiþs	ɸ ɛ r l ɛ s t ɪ θ s
faírneis	ɸ ɛ r n i s
faírniþa	ɸ ɛ r n ɪ θ a
faírns	ɸ ɛ r n̥ s
faírra	ɸ ɛ rː a
faírraþrō	ɸ ɛ rː a θ r o
faírrinnan	ɸ ɛ rː ɪ nː a n
faírwaúrkjan	ɸ ɛ r w ɔ r k j a n
faírweit	ɸ ɛ r w i t
faírweitan	ɸ ɛ r w i t a n
faírweitjan	ɸ ɛ r w i t j a n
faírweitl	ɸ ɛ r w i t l̥
faírzna	ɸ ɛ r z n a
falda	ɸ a l d a
falka	ɸ a l k a
falþ	ɸ a l θ
falþaba	ɸ a l θ a β a
falþan	ɸ a l θ a n
falþei	ɸ a l θ i
falþs	ɸ a l θ s
falwiska	ɸ a l w ɪ s k a
falws	ɸ a l w s
fana	ɸ a n a
fani	ɸ a n ɪ
fanþja	ɸ a n θ j a
fara	ɸ a r a
faran	ɸ a r a n
Faraō	ɸ a r a o
Fareisaius	ɸ a r i s ɛ u s
farjan	ɸ a r j a n
farþa	ɸ a r θ a
farwa	ɸ a r w a
faskja	ɸ a s k j a
fasta	ɸ a s t a
fastan	ɸ a s t a n
fasteis	ɸ a s t i s
fastnēms	ɸ a s t n e m s
fasts	ɸ a s t s
fastubni	ɸ a s t u β n ɪ
fata	ɸ a t a
faþa	ɸ a θ a
faþs	ɸ a θ s
faúhō	ɸ ɔ h o
faúr	ɸ ɔ r
faúra	ɸ ɔ r a
faúradaúri	ɸ ɔ r a ð ɔ r ɪ
faúrafilli	ɸ ɔ r a ɸ ɪ lː ɪ
faúragagga	ɸ ɔ r a ɣ a ŋ ɡ a
faúragaggan	ɸ ɔ r a ɣ a ŋ ɡ a n
faúragaggi	ɸ ɔ r a ɣ a ŋ ɡ ɪ
faúragaggja	ɸ ɔ r a ɣ a ŋ ɡ j a
faúragahaitan	ɸ ɔ r a ɣ a h ɛ t a n
faúragahugjan	ɸ ɔ r a ɣ a h u ɣ j a n
faúragaleikan	ɸ ɔ r a ɣ a l i k a n
faúragamanwjan	ɸ ɔ r a ɣ a m a n w j a n
faúragamēljan	ɸ ɔ r a ɣ a m e l j a n
faúragaraidjan	ɸ ɔ r a ɣ a r ɛ ð j a n
faúragarēdan	ɸ ɔ r a ɣ a r e ð a n
faúragasandjan	ɸ ɔ r a ɣ a s a n d j a n
faúragasatjan	ɸ ɔ r a ɣ a s a t j a n
faúragateihan	ɸ ɔ r a ɣ a t i h a n
faúrahāh	ɸ ɔ r a h a h
faúrahāhan	ɸ ɔ r a h a h a n
faúramanwjan	ɸ ɔ r a m a n w j a n
faúramaþleis	ɸ ɔ r a m a θ l i s
faúramaþli	ɸ ɔ r a m a θ l ɪ
faúramēljan	ɸ ɔ r a m e l j a n
faúraqiman	ɸ ɔ r a kʷ ɪ m a n
fauraqiþan	ɸ ɔ r a kʷ ɪ θ a n
faúrarahnjan	ɸ ɔ r a r a h n j a n
faúrastandan	ɸ ɔ r a s t a n d a n
faúratani	ɸ ɔ r a t a n ɪ
faúrawēnjan	ɸ ɔ r a w e n j a n
faúrawisan	ɸ ɔ r a w ɪ s a n
faúrbaúhts	ɸ ɔ r b ɔ h t s
faúrbigaggan	ɸ ɔ r b ɪ ɣ a ŋ ɡ a n
faúrbisniwan	ɸ ɔ r b ɪ s n ɪ w a n
faúrbiudan	ɸ ɔ r b ɪ u ð a n
faúrbjan	ɸ ɔ r b j a n
faúrdammjan	ɸ ɔ r d a mː j a n
faúrdōmeins	ɸ ɔ r d o m i n s
faúrdōmjan	ɸ ɔ r d o m j a n
faúrgaggan	ɸ ɔ r ɡ a ŋ ɡ a n
faúrhāh	ɸ ɔ r h a h
faúrhāhan	ɸ ɔ r h a h a n
faurhs	ɸ ɔ r h s
faúrhtei	ɸ ɔ r h t i
faúrhtjan	ɸ ɔ r h t j a n
faúrhts	ɸ ɔ r h t s
faúrlageins	ɸ ɔ r l a ɣ i n s
faúrlagjan	ɸ ɔ r l a ɣ j a n
faúrmūljan	ɸ ɔ r m u l j a n
faúrqiþan	ɸ ɔ r kʷ ɪ θ a n
faúrrinnan	ɸ ɔ rː ɪ nː a n
faurs	ɸ ɔ r s
faúrsigljan	ɸ ɔ r s ɪ ɣ l j a n
faúrsniwan	ɸ ɔ r s n ɪ w a n
faúrstandan	ɸ ɔ r s t a n d a n
faurstass	ɸ ɔ r s t a sː
faúrstasseis	ɸ ɔ r s t a sː i s
faúrþis	ɸ ɔ r θ ɪ s
faúrþizei	ɸ ɔ r θ ɪ z i
faúrwaipjan	ɸ ɔ r w ɛ p j a n
faúrwalwjan	ɸ ɔ r w a l w j a n
faúrweis	ɸ ɔ r w i s
faus	ɸ ɔ s
fēhaba	ɸ e h a β a
fēhs	ɸ e h s
fenea	ɸ e n e a
fēr	ɸ e r
fēra	ɸ e r a
fērja	ɸ e r j a
fers	ɸ e r s
fēteins	ɸ e t i n s
fētjan	ɸ e t j a n
feusa	ɸ e u s a
fidur	ɸ ɪ ð u r
fidurdōgs	ɸ ɪ ð u r d o ɣ s
fidurfalþs	ɸ ɪ ð u r ɸ a l θ s
fidurragineis	ɸ ɪ ð u rː a ɣ ɪ n i s
fidurragini	ɸ ɪ ð u rː a ɣ ɪ n ɪ
fidwōr	ɸ ɪ ð w o r
fidwōrtaíhun	ɸ ɪ ð w o r t ɛ h u n
fidwōrþūsundjos	ɸ ɪ ð w o r θ u s u n d j o s
figgragulþ	ɸ ɪ ŋ ɡ r a ɣ u l θ
figgrs	ɸ ɪ ŋ ɡ r̥ s
fijan	ɸ ɪ j a n
fijands	ɸ ɪ j a n d s
fijaþwa	ɸ ɪ j a θ w a
filaus	ɸ ɪ l ɔ s
filhan	ɸ ɪ l h a n
filigri	ɸ ɪ l ɪ ɣ r ɪ
fill	ɸ ɪ lː
filleins	ɸ ɪ lː i n s
fills	ɸ ɪ lː s
films	ɸ ɪ l m̥ s
filtur	ɸ ɪ l t u r
filu	ɸ ɪ l u
filudeis	ɸ ɪ l u ð i s
filudeisei	ɸ ɪ l u ð i s i
filufaíhs	ɸ ɪ l u ɸ ɛ h s
filugalaufs	ɸ ɪ l u ɣ a l ɔ ɸ s
filusna	ɸ ɪ l u s n a
filuwaúrdei	ɸ ɪ l u w ɔ r d i
filuwaúrdjan	ɸ ɪ l u w ɔ r d j a n
filuwaúrds	ɸ ɪ l u w ɔ r d s
fimf	ɸ ɪ m ɸ
fimfhunda	ɸ ɪ m ɸ h u n d a
fimfta	ɸ ɪ m ɸ t a
fimftaíhun	ɸ ɪ m ɸ t ɛ h u n
fimftataíhunda	ɸ ɪ m ɸ t a t ɛ h u n d a
fimftigjus	ɸ ɪ m ɸ t ɪ ɣ j u s
fimfþūsunjōs	ɸ ɪ m ɸ θ u s u n j o s
finja	ɸ ɪ n j a
Finnhaiþas	ɸ ɪ nː h ɛ θ a s
finþan	ɸ ɪ n θ a n
fiskja	ɸ ɪ s k j a
fiskōn	ɸ ɪ s k o n
fisks	ɸ ɪ s k s
fitan	ɸ ɪ t a n
flahta	ɸ l a h t a
flaíhtan	ɸ l ɛ h t a n
flaskō	ɸ l a s k o
flautjan	ɸ l ɔ t j a n
flauts	ɸ l ɔ t s
flōdus	ɸ l o ð u s
flōkan	ɸ l o k a n
fōdeins	ɸ o ð i n s
fōdjan	ɸ o ð j a n
fōdr	ɸ o ð r̥
fōn	ɸ o n
fōtubandi	ɸ o t u β a n d ɪ
fōtubaūrd	ɸ o t u β ɔ r d
fōtus	ɸ o t u s
fra	ɸ r a
fraatjan	ɸ r a a t j a n
frabaíran	ɸ r a β ɛ r a n
frabaúhtabōka	ɸ r a β ɔ h t a β o k a
frabugjan	ɸ r a β u ɣ j a n
fradailjan	ɸ r a ð ɛ l j a n
fragan	ɸ r a ɣ a n
fragiban	ɸ r a ɣ ɪ β a n
fragifts	ɸ r a ɣ ɪ ɸ t s
fragildan	ɸ r a ɣ ɪ l d a n
Fragka	ɸ r a ŋ k a
frahinþan	ɸ r a h ɪ n θ a n
fraíhnan	ɸ r ɛ h n a n
fraisan	ɸ r ɛ s a n
fraista	ɸ r ɛ s t a
fraistōn	ɸ r ɛ s t o n
fraistubni	ɸ r ɛ s t u β n ɪ
fraitan	ɸ r ɛ t a n
fraiw	ɸ r ɛ w
frakunnan	ɸ r a k u nː a n
frakunþs	ɸ r a k u n θ s
fralēt	ɸ r a l e t
fralētan	ɸ r a l e t a n
fralēts	ɸ r a l e t s
fralēwjan	ɸ r a l e w j a n
fraliusan	ɸ r a l ɪ u s a n
fralusnan	ɸ r a l u s n a n
fralusts	ɸ r a l u s t s
fram	ɸ r a m
framaldrs	ɸ r a m a l d r̥ s
framaþeis	ɸ r a m a θ i s
framaþjan	ɸ r a m a θ j a n
framgāhts	ɸ r a m ɡ a h t s
framis	ɸ r a m ɪ s
frams	ɸ r a m s
framwaírþis	ɸ r a m w ɛ r θ ɪ s
framwairþs	ɸ r a m w ɛ r θ s
framwigis	ɸ r a m w ɪ ɣ ɪ s
franiman	ɸ r a n ɪ m a n
fraqiman	ɸ r a kʷ ɪ m a n
fraqisteins	ɸ r a kʷ ɪ s t i n s
fraqistjan	ɸ r a kʷ ɪ s t j a n
fraqistnan	ɸ r a kʷ ɪ s t n a n
fraqiþan	ɸ r a kʷ ɪ θ a n
frarinnan	ɸ r a r ɪ nː a n
fraslindan	ɸ r a s l ɪ n d a n
frastisibja	ɸ r a s t ɪ s ɪ β j a
frasts	ɸ r a s t s
fraþi	ɸ r a θ ɪ
fraþjamarzeins	ɸ r a θ j a m a r z i n s
fraþjan	ɸ r a θ j a n
fraþjands	ɸ r a θ j a n d s
fraþjei	ɸ r a θ j i
fraþjis	ɸ r a θ j ɪ s
frauja	ɸ r ɔ j a
fraujinassus	ɸ r ɔ j ɪ n a sː u s
fraujinōn	ɸ r ɔ j ɪ n o n
fraujinōnds	ɸ r ɔ j ɪ n o n d s
fraujis	ɸ r ɔ j ɪ s
fraus	ɸ r ɔ s
fratrudan	ɸ r a t r u ð a n
frawaírpan	ɸ r a w ɛ r p a n
frawaírþan	ɸ r a w ɛ r θ a n
frawardeins	ɸ r a w a r d i n s
frawardjan	ɸ r a w a r d j a n
frawaúrhts	ɸ r a w ɔ r h t s
frawaúrkjan	ɸ r a w ɔ r k j a n
fraweit	ɸ r a w i t
fraweitan	ɸ r a w i t a n
frawilwan	ɸ r a w ɪ l w a n
frawisan	ɸ r a w ɪ s a n
frawrikan	ɸ r a w r ɪ k a n
frawrōhjan	ɸ r a w r o h j a n
freideins	ɸ r i ð i n s
freidjan	ɸ r i ð j a n
freihals	ɸ r i h a l s
freis	ɸ r i s
freiþs	ɸ r i θ s
friaþwamilds	ɸ r ɪ a θ w a m ɪ l d s
frijaþwa	ɸ r ɪ j a θ w a
frijei	ɸ r ɪ j i
frijōn	ɸ r ɪ j o n
frijōndi	ɸ r ɪ j o n d ɪ
frijōnds	ɸ r ɪ j o n d s
frijōns	ɸ r ɪ j o n s
frikei	ɸ r ɪ k i
friks	ɸ r ɪ k s
frisahtjan	ɸ r ɪ s a h t j a n
frisahtnan	ɸ r ɪ s a h t n a n
frisahts	ɸ r ɪ s a h t s
frisks	ɸ r ɪ s k s
friþōn	ɸ r ɪ θ o n
friþus	ɸ r ɪ θ u s
frius	ɸ r ɪ u s
friusan	ɸ r ɪ u s a n
frōdaba	ɸ r o ð a β a
frōdei	ɸ r o ð i
frōþs	ɸ r o θ s
frum	ɸ r u m
fruma	ɸ r u m a
frumabaúr	ɸ r u m a β ɔ r
frumadei	ɸ r u m a ð i
frumaþ	ɸ r u m a θ
frumaþeis	ɸ r u m a θ i s
frumei	ɸ r u m i
frumist	ɸ r u m ɪ s t
frumisti	ɸ r u m ɪ s t ɪ
frumists	ɸ r u m ɪ s t s
frumjan	ɸ r u m j a n
fugls	ɸ u ɣ l̥ s
fula	ɸ u l a
fulcus	ɸ u l c u s
fulgins	ɸ u l ɡ ɪ n s
fulhsni	ɸ u l h s n ɪ
fulk	ɸ u l k
fullafahjan	ɸ u lː a ɸ a h j a n
fullafraþjan	ɸ u lː a ɸ r a θ j a n
fullatōjis	ɸ u lː a t o j ɪ s
fullaweis	ɸ u lː a w i s
fullaweisjan	ɸ u lː a w i s j a n
fullawita	ɸ u lː a w ɪ t a
fullei	ɸ u lː i
fulleins	ɸ u lː i n s
fulleiþs	ɸ u lː i θ s
fullja	ɸ u lː j a
fulljan	ɸ u lː j a n
fullnan	ɸ u lː n a n
fullō	ɸ u lː o
fulls	ɸ u lː s
fūls	ɸ u l s
fulþ	ɸ u l θ
funisks	ɸ u n ɪ s k s
funs	ɸ u n s
fwnīkisks	ɸ w n i k ɪ s k s
ga	ɡ a
gaaggwei	ɡ a a ɡ ɡ w i
gaaggweins	ɡ a a ɡ ɡ w i n s
gaaggwjan	ɡ a a ɡ ɡ w j a n
gaaiginōn	ɡ a ɛ ɣ ɪ n o n
gaainan	ɡ a ɛ n a n
gaaistan	ɡ a ɛ s t a n
gaaiwiskōn	ɡ a ɛ w ɪ s k o n
gaandjan	ɡ a a n d j a n
gaar	ɡ a a r
gaarbja	ɡ a a r b j a
gaarman	ɡ a a r m a n
gaaukan	ɡ a ɔ k a n
gabaidjan	ɡ a β ɛ ð j a n
gabaíran	ɡ a β ɛ r a n
gabaírgan	ɡ a β ɛ r ɡ a n
gabaírhteins	ɡ a β ɛ r h t i n s
gabaírhtjan	ɡ a β ɛ r h t j a n
gabandwjan	ɡ a β a n d w j a n
gabatnan	ɡ a β a t n a n
gabáuan	ɡ a β ɔ a n
gabaúr	ɡ a β ɔ r
gabaúrgja	ɡ a β ɔ r ɡ j a
gabaúrjaba	ɡ a β ɔ r j a β a
gabaúrjō	ɡ a β ɔ r j o
gabaúrjōn	ɡ a β ɔ r j o n
gabaúrjōþus	ɡ a β ɔ r j o θ u s
gabaúrþiwaurd	ɡ a β ɔ r θ ɪ w ɔ r d
gabaúrþs	ɡ a β ɔ r θ s
gabei	ɡ a β i
gabeidan	ɡ a β i ð a n
gabeistjan	ɡ a β i s t j a n
gabidjan	ɡ a β ɪ ð j a n
gabigaba	ɡ a β ɪ ɣ a β a
gabigjan	ɡ a β ɪ ɣ j a n
gabignan	ɡ a β ɪ ɣ n a n
gabigs	ɡ a β ɪ ɣ s
gabinda	ɡ a β ɪ n d a
gabindan	ɡ a β ɪ n d a n
gabindi	ɡ a β ɪ n d ɪ
gabiugan	ɡ a β ɪ u ɣ a n
gablauþjan	ɡ a β l ɔ θ j a n
gableiþeins	ɡ a β l i θ i n s
gableiþjan	ɡ a β l i θ j a n
gablindjan	ɡ a β l ɪ n d j a n
gabōtjan	ɡ a β o t j a n
gabrannjan	ɡ a β r a nː j a n
gabrikan	ɡ a β r ɪ k a n
gabruka	ɡ a β r u k a
gabundi	ɡ a β u n d ɪ
gadaban	ɡ a ð a β a n
gadaila	ɡ a ð ɛ l a
gadailjan	ɡ a ð ɛ l j a n
gadaubjan	ɡ a ð ɔ β j a n
gadauka	ɡ a ð ɔ k a
gadaúrsan	ɡ a ð ɔ r s a n
gadauþjan	ɡ a ð ɔ θ j a n
gadauþnan	ɡ a ð ɔ θ n a n
gadeltha	ɡ a ð e l t h a
gadēþs	ɡ a ð e θ s
gadigan	ɡ a ð ɪ ɣ a n
gadigis	ɡ a ð ɪ ɣ ɪ s
gadiliggs	ɡ a ð ɪ l ɪ ŋ ɡ s
gadiupjan	ɡ a ð ɪ u p j a n
gadōfs	ɡ a ð o ɸ s
gadōmjan	ɡ a ð o m j a n
gadraban	ɡ a ð r a β a n
gadragan	ɡ a ð r a ɣ a n
gadragkjan	ɡ a ð r a ŋ k j a n
gadraúhts	ɡ a ð r ɔ h t s
gadrausjan	ɡ a ð r ɔ s j a n
gadrigkan	ɡ a ð r ɪ ŋ k a n
gadriusan	ɡ a ð r ɪ u s a n
gadrōbnan	ɡ a ð r o β n a n
gafāh	ɡ a ɸ a h
gafāhan	ɡ a ɸ a h a n
gafahrjan	ɡ a ɸ a h r j a n
gafaihan	ɡ a ɸ ɛ h a n
gafaihōn	ɡ a ɸ ɛ h o n
gafairinōnds	ɡ a ɸ ɛ r ɪ n o n d s
gafairinōþs	ɡ a ɸ ɛ r ɪ n o θ s
gafastan	ɡ a ɸ a s t a n
gafaúrds	ɡ a ɸ ɔ r d s
gafaurs	ɡ a ɸ ɔ r s
gafēhaba	ɡ a ɸ e h a β a
gafēhs	ɡ a ɸ e h s
gafēteins	ɡ a ɸ e t i n s
gafētjan	ɡ a ɸ e t j a n
gafilh	ɡ a ɸ ɪ l h
gafilhan	ɡ a ɸ ɪ l h a n
gafraíhnan	ɡ a ɸ r ɛ h n a n
gafraþjei	ɡ a ɸ r a θ j i
gafraþjis	ɡ a ɸ r a θ j ɪ s
gafraujinōn	ɡ a ɸ r ɔ j ɪ n o n
gafreideins	ɡ a ɸ r i ð i n s
gafreidjan	ɡ a ɸ r i ð j a n
gafrijōns	ɡ a ɸ r ɪ j o n s
gafrisahtjan	ɡ a ɸ r ɪ s a h t j a n
gafrisahtnan	ɡ a ɸ r ɪ s a h t n a n
gafriþōn	ɡ a ɸ r ɪ θ o n
gafriþōns	ɡ a ɸ r ɪ θ o n s
gafulgins	ɡ a ɸ u l ɡ ɪ n s
gafullaweisjan	ɡ a ɸ u lː a w i s j a n
gafulljan	ɡ a ɸ u lː j a n
gafullnan	ɡ a ɸ u lː n a n
gagaggan	ɡ a ɣ a ŋ ɡ a n
gagahaftjan	ɡ a ɣ a h a ɸ t j a n
gagaleikōn	ɡ a ɣ a l i k o n
gagamainjan	ɡ a ɣ a m ɛ n j a n
gagatilōn	ɡ a ɣ a t ɪ l o n
gagawaírþjan	ɡ a ɣ a w ɛ r θ j a n
gagawaírþnan	ɡ a ɣ a w ɛ r θ n a n
gageigan	ɡ a ɣ i ɣ a n
gagg	ɡ a ŋ ɡ
gagga	ɡ a ŋ ɡ a
gaggan	ɡ a ŋ ɡ a n
gaggi	ɡ a ŋ ɡ ɪ
gaggja	ɡ a ŋ ɡ j a
gaggjan	ɡ a ŋ ɡ j a n
gagrēfts	ɡ a ɣ r e ɸ t s
gagudaba	ɡ a ɣ u ð a β a
gagudei	ɡ a ɣ u ð i
gaguþs	ɡ a ɣ u θ s
gahaban	ɡ a h a β a n
gahabands	ɡ a h a β a n d s
gahaftjan	ɡ a h a ɸ t j a n
gahaftnan	ɡ a h a ɸ t n a n
gahafts	ɡ a h a ɸ t s
gahāhjis	ɡ a h a h j ɪ s
gahāhjō	ɡ a h a h j o
gahailjan	ɡ a h ɛ l j a n
gahailnan	ɡ a h ɛ l n a n
gahails	ɡ a h ɛ l s
gahait	ɡ a h ɛ t
gahaitan	ɡ a h ɛ t a n
gahamōn	ɡ a h a m o n
gahardjan	ɡ a h a r d j a n
gahaunjan	ɡ a h ɔ n j a n
gahauseins	ɡ a h ɔ s i n s
gahausjan	ɡ a h ɔ s j a n
gahilpan	ɡ a h ɪ l p a n
gahlaiba	ɡ a h l ɛ β a
gahlaifs	ɡ a h l ɛ ɸ s
gahnaiwjan	ɡ a h n ɛ w j a n
gahnipnan	ɡ a h n ɪ p n a n
gahōbains	ɡ a h o β ɛ n s
gahōban	ɡ a h o β a n
gahōrinōn	ɡ a h o r ɪ n o n
gahraineins	ɡ a h r ɛ n i n s
gahrainjan	ɡ a h r ɛ n j a n
gahts	ɡ a h t s
gāhts	ɡ a h t s
gahugds	ɡ a h u ɣ d s
gahugjan	ɡ a h u ɣ j a n
gahuljan	ɡ a h u l j a n
gaƕaírban	ɡ a ʍ ɛ r b a n
gaƕaírbs	ɡ a ʍ ɛ r b s
gaƕatjan	ɡ a ʍ a t j a n
gaƕeilains	ɡ a ʍ i l ɛ n s
gaƕeilan	ɡ a ʍ i l a n
gaƕeitjan	ɡ a ʍ i t j a n
gaƕōtjan	ɡ a ʍ o t j a n
gaíaínna	ɡ ɛ ɛ nː a
gaibnjan	ɡ ɛ β n j a n
gaida	ɡ ɛ ð a
gaidreigōn	ɡ ɛ ð r i ɣ o n
gaidw	ɡ ɛ ð w
gailjan	ɡ ɛ l j a n
gails	ɡ ɛ l s
gain	ɡ ɛ n
gainōn	ɡ ɛ n o n
gaírda	ɡ ɛ r d a
gairdan	ɡ ɛ r d a n
gaírnei	ɡ ɛ r n i
gairnjan	ɡ ɛ r n j a n
gaírns	ɡ ɛ r n̥ s
gaíruni	ɡ ɛ r u n ɪ
gais	ɡ ɛ s
gaisjan	ɡ ɛ s j a n
gaitein	ɡ ɛ t i n
gaiteins	ɡ ɛ t i n s
gaits	ɡ ɛ t s
gajiukan	ɡ a j ɪ u k a n
gajuk	ɡ a j u k
gajuka	ɡ a j u k a
gajukō	ɡ a j u k o
gakannjan	ɡ a k a nː j a n
gakarōn	ɡ a k a r o n
gakausjan	ɡ a k ɔ s j a n
gakiusan	ɡ a k ɪ u s a n
gakrōtōn	ɡ a k r o t o n
gakunds	ɡ a k u n d s
gakunnan	ɡ a k u nː a n
gakunþs	ɡ a k u n θ s
gakusans	ɡ a k u s a n s
gakusts	ɡ a k u s t s
gala	ɡ a l a
galagjan	ɡ a l a ɣ j a n
galaisjan	ɡ a l ɛ s j a n
galaista	ɡ a l ɛ s t a
galaistjan	ɡ a l ɛ s t j a n
galan	ɡ a l a n
galatjan	ɡ a l a t j a n
galaþōn	ɡ a l a θ o n
galaubei	ɡ a l ɔ β i
galaubeins	ɡ a l ɔ β i n s
galaubjan	ɡ a l ɔ β j a n
galaufs	ɡ a l ɔ ɸ s
galaugnjan	ɡ a l ɔ ɣ n j a n
galausjan	ɡ a l ɔ s j a n
gald	ɡ a l d
galeika	ɡ a l i k a
galeikan	ɡ a l i k a n
galeiki	ɡ a l i k ɪ
galeikō	ɡ a l i k o
galeikōn	ɡ a l i k o n
galeiks	ɡ a l i k s
galeiþan	ɡ a l i θ a n
galēkinōn	ɡ a l e k ɪ n o n
galēwjan	ɡ a l e w j a n
galēwjands	ɡ a l e w j a n d s
galga	ɡ a l ɡ a
galigri	ɡ a l ɪ ɣ r ɪ
galisan	ɡ a l ɪ s a n
galiug	ɡ a l ɪ u ɣ
galiugaapaústaúlus	ɡ a l ɪ u ɣ a a p ɔ s t ɔ l u s
galiugabrōþar	ɡ a l ɪ u ɣ a β r o θ a r
galiugaguþ	ɡ a l ɪ u ɣ a ɣ u θ
galiugan	ɡ a l ɪ u ɣ a n
galiugapraúfētus	ɡ a l ɪ u ɣ a p r ɔ ɸ e t u s
galiugaweitwōþs	ɡ a l ɪ u ɣ a w i t w o θ s
galiugaxristus	ɡ a l ɪ u ɣ a χ r ɪ s t u s
galiuhtjan	ɡ a l ɪ u h t j a n
galþeis	ɡ a l θ i s
galūkan	ɡ a l u k a n
galuknan	ɡ a l u k n a n
gamagan	ɡ a m a ɣ a n
gamaindūþs	ɡ a m ɛ n d u θ s
gamainei	ɡ a m ɛ n i
gamainja	ɡ a m ɛ n j a
gamainjan	ɡ a m ɛ n j a n
gamains	ɡ a m ɛ n s
gamainþs	ɡ a m ɛ n θ s
gamaitan	ɡ a m ɛ t a n
gamaiþs	ɡ a m ɛ θ s
gamalteins	ɡ a m a l t i n s
gamaltjan	ɡ a m a l t j a n
gamalwjan	ɡ a m a l w j a n
gaman	ɡ a m a n
gamanwjan	ɡ a m a n w j a n
gamarka	ɡ a m a r k a
gamarkō	ɡ a m a r k o
gamarkōn	ɡ a m a r k o n
gamarzeins	ɡ a m a r z i n s
gamarzjan	ɡ a m a r z j a n
gamatjan	ɡ a m a t j a n
gamaudeins	ɡ a m ɔ ð i n s
gamaudjan	ɡ a m ɔ ð j a n
gamaúrgjan	ɡ a m ɔ r ɡ j a n
gamēleins	ɡ a m e l i n s
gamēliþsbzw.þatagamēlidō	ɡ a m e l ɪ θ s b z w θ a t a ɣ a m e l ɪ ð o
gamēljan	ɡ a m e l j a n
gamikiljan	ɡ a m ɪ k ɪ l j a n
gaminþi	ɡ a m ɪ n θ ɪ
gamitan	ɡ a m ɪ t a n
gamitōn	ɡ a m ɪ t o n
gamitōns	ɡ a m ɪ t o n s
gamiþsandjan	ɡ a m ɪ θ s a n d j a n
gamōtan	ɡ a m o t a n
gamōtjan	ɡ a m o t j a n
gamunan	ɡ a m u n a n
gamunds	ɡ a m u n d s
ganagljan	ɡ a n a ɣ l j a n
ganah	ɡ a n a h
ganaitjan	ɡ a n ɛ t j a n
ganamnjan	ɡ a n a m n j a n
ganasjan	ɡ a n a s j a n
ganatjan	ɡ a n a t j a n
ganaúha	ɡ a n ɔ h a
ganaúhan	ɡ a n ɔ h a n
ganawistrōn	ɡ a n a w ɪ s t r o n
gands	ɡ a n d s
ganiman	ɡ a n ɪ m a n
ganisan	ɡ a n ɪ s a n
ganists	ɡ a n ɪ s t s
ganiþjis	ɡ a n ɪ θ j ɪ s
ganiutan	ɡ a n ɪ u t a n
ganōhjan	ɡ a n o h j a n
ganōhnan	ɡ a n o h n a n
ganōhs	ɡ a n o h s
ganōn	ɡ a n o n
gans	ɡ a n s
gansjan	ɡ a n s j a n
ganta	ɡ a n t a
gapaidōn	ɡ a p ɛ ð o n
gaqiman	ɡ a kʷ ɪ m a n
gaqiss	ɡ a kʷ ɪ sː
gaqiþan	ɡ a kʷ ɪ θ a n
gaqiujan	ɡ a kʷ ɪ u j a n
gaqiunan	ɡ a kʷ ɪ u n a n
gaqumþs	ɡ a kʷ u m θ s
garaginōn	ɡ a r a ɣ ɪ n o n
garahnjan	ɡ a r a h n j a n
garaideins	ɡ a r ɛ ð i n s
garaidjan	ɡ a r ɛ ð j a n
garaíhtaba	ɡ a r ɛ h t a β a
garaíhtei	ɡ a r ɛ h t i
garaíhteins	ɡ a r ɛ h t i n s
garaíhtiþa	ɡ a r ɛ h t ɪ θ a
garaíhtjan	ɡ a r ɛ h t j a n
garaíhts	ɡ a r ɛ h t s
garaiþs	ɡ a r ɛ θ s
garaþan	ɡ a r a θ a n
garaþjan	ɡ a r a θ j a n
garazna	ɡ a r a z n a
garaznō	ɡ a r a z n o
garba	ɡ a r b a
garda	ɡ a r d a
gardawaldands	ɡ a r d a w a l d a n d s
gardi	ɡ a r d ɪ
gardiggs	ɡ a r d ɪ ŋ ɡ s
gardingatus	ɡ a r d ɪ n ɡ a t u s
gardingus	ɡ a r d ɪ n ɡ u s
gards	ɡ a r d s
garēdaba	ɡ a r e ð a β a
garēdan	ɡ a r e ð a n
garēhsns	ɡ a r e h s n̥ s
garēþs	ɡ a r e θ s
garinnan	ɡ a r ɪ nː a n
gariudan	ɡ a r ɪ u ð a n
gariudei	ɡ a r ɪ u ð i
gariudi	ɡ a r ɪ u ð ɪ
gariuþs	ɡ a r ɪ u θ s
gart	ɡ a r t
garūni	ɡ a r u n ɪ
garunjō	ɡ a r u n j o
garuns	ɡ a r u n s
garwi	ɡ a r w ɪ
garwōn	ɡ a r w o n
garws	ɡ a r w s
gasahts	ɡ a s a h t s
gasaíƕan	ɡ a s ɛ ʍ a n
gasaíƕans	ɡ a s ɛ ʍ a n s
gasakan	ɡ a s a k a n
gasalbōn	ɡ a s a l b o n
gasalja	ɡ a s a l j a
gasaljan	ɡ a s a l j a n
gasandjan	ɡ a s a n d j a n
gasateins	ɡ a s a t i n s
gasatjan	ɡ a s a t j a n
gasibjōn	ɡ a s ɪ β j o n
gasiggqan	ɡ a s ɪ ŋ ɡ kʷ a n
gasigljan	ɡ a s ɪ ɣ l j a n
gasinþa	ɡ a s ɪ n θ a
gasinþja	ɡ a s ɪ n θ j a
gasitan	ɡ a s ɪ t a n
gaskadweins	ɡ a s k a ð w i n s
gaskadwjan	ɡ a s k a ð w j a n
gaskafts	ɡ a s k a ɸ t s
gaskaidansik	ɡ a s k ɛ ð a n s ɪ k
gaskaideins	ɡ a s k ɛ ð i n s
gaskaidnan	ɡ a s k ɛ ð n a n
gaskalki	ɡ a s k a l k ɪ
gaskamansik	ɡ a s k a m a n s ɪ k
gaskapjan	ɡ a s k a p j a n
gaskaþjan	ɡ a s k a θ j a n
gaskeirjan	ɡ a s k i r j a n
gaskōhi	ɡ a s k o h ɪ
gaskōhs	ɡ a s k o h s
gaslawan	ɡ a s l a w a n
gasleiþjan	ɡ a s l i θ j a n
gaslēpan	ɡ a s l e p a n
gasmeitan	ɡ a s m i t a n
gasmiþōn	ɡ a s m ɪ θ o n
gasniumjan	ɡ a s n ɪ u m j a n
gasniwan	ɡ a s n ɪ w a n
gasōkjan	ɡ a s o k j a n
gasōþjan	ɡ a s o θ j a n
gaspeiwan	ɡ a s p i w a n
gaspillōn	ɡ a s p ɪ lː o n
gastagqjan	ɡ a s t a ŋ kʷ j a n
gastaldan	ɡ a s t a l d a n
gastalds	ɡ a s t a l d s
gastandan	ɡ a s t a n d a n
gastaúrknan	ɡ a s t ɔ r k n a n
gasteigan	ɡ a s t i ɣ a n
gastiggqan	ɡ a s t ɪ ŋ ɡ kʷ a n
gastigōdei	ɡ a s t ɪ ɣ o ð i
gastigōþs	ɡ a s t ɪ ɣ o θ s
gastōjan	ɡ a s t o j a n
gastōþan	ɡ a s t o θ a n
gastōþs	ɡ a s t o θ s
gastraujan	ɡ a s t r ɔ j a n
gasts	ɡ a s t s
gasūljan	ɡ a s u l j a n
gasunjōn	ɡ a s u n j o n
gasupōn	ɡ a s u p o n
gaswēran	ɡ a s w e r a n
gaswikunþjan	ɡ a s w ɪ k u n θ j a n
gaswiltan	ɡ a s w ɪ l t a n
gaswinþjan	ɡ a s w ɪ n θ j a n
gaswinþnan	ɡ a s w ɪ n θ n a n
gaswōgjan	ɡ a s w o ɣ j a n
gataiknjan	ɡ a t ɛ k n j a n
gataíran	ɡ a t ɛ r a n
gatalzjan	ɡ a t a l z j a n
gatamjan	ɡ a t a m j a n
gatandjan	ɡ a t a n d j a n
gatarhjan	ɡ a t a r h j a n
gatarnjan	ɡ a t a r n j a n
gatass	ɡ a t a sː
gataujan	ɡ a t ɔ j a n
gataúra	ɡ a t ɔ r a
gataúrnan	ɡ a t ɔ r n a n
gataúrþs	ɡ a t ɔ r θ s
gateihan	ɡ a t i h a n
gatēmiba	ɡ a t e m ɪ β a
gatēms	ɡ a t e m s
gatēwiþs	ɡ a t e w ɪ θ s
gatēwjan	ɡ a t e w j a n
gatilaba	ɡ a t ɪ l a β a
gatilōn	ɡ a t ɪ l o n
gatils	ɡ a t ɪ l s
gatiman	ɡ a t ɪ m a n
gatimreins	ɡ a t ɪ m r i n s
gatimrjan	ɡ a t ɪ m r j a n
gatimrjō	ɡ a t ɪ m r j o
gatiuhan	ɡ a t ɪ u h a n
gatráuan	ɡ a t r ɔ a n
gatrudan	ɡ a t r u ð a n
gatulgjan	ɡ a t u l ɡ j a n
gatwō	ɡ a t w o
gaþagki	ɡ a θ a ŋ k ɪ
gaþahan	ɡ a θ a h a n
gaþaírsan	ɡ a θ ɛ r s a n
gaþarban	ɡ a θ a r b a n
gaþaúrbs	ɡ a θ ɔ r b s
gaþaúrpan	ɡ a θ ɔ r p a n
gaþaúrsnan	ɡ a θ ɔ r s n a n
gaþeihan	ɡ a θ i h a n
gaþiuþjan	ɡ a θ ɪ u θ j a n
gaþiwan	ɡ a θ ɪ w a n
gaþlahsnan	ɡ a θ l a h s n a n
gaþlaihan	ɡ a θ l ɛ h a n
gaþlaihts	ɡ a θ l ɛ h t s
gaþliuhan	ɡ a θ l ɪ u h a n
gaþrafsteins	ɡ a θ r a ɸ s t i n s
gaþrafstjan	ɡ a θ r a ɸ s t j a n
gaþrask	ɡ a θ r a s k
gaþreihan	ɡ a θ r i h a n
gaþriskan	ɡ a θ r ɪ s k a n
gaþulan	ɡ a θ u l a n
gaþwastjan	ɡ a θ w a s t j a n
gaud	ɡ ɔ ð
gauja	ɡ ɔ j a
gauma	ɡ ɔ m a
gaumjan	ɡ ɔ m j a n
gaunlēdjan	ɡ ɔ n l e ð j a n
gaunōn	ɡ ɔ n o n
gaunōþus	ɡ ɔ n o θ u s
gaur	ɡ ɔ r
gaurei	ɡ ɔ r i
gauriþa	ɡ ɔ r ɪ θ a
gaurjan	ɡ ɔ r j a n
gaurs	ɡ ɔ r s
gaus	ɡ ɔ s
Gauti	ɡ ɔ t ɪ
Gauts	ɡ ɔ t s
gawadjōn	ɡ a w a ð j o n
gawagiþs	ɡ a w a ɣ ɪ θ s
gawagjan	ɡ a w a ɣ j a n
gawaírpan	ɡ a w ɛ r p a n
gawaírþan	ɡ a w ɛ r θ a n
gawaírþeigs	ɡ a w ɛ r θ i ɣ s
gawaírþi	ɡ a w ɛ r θ ɪ
gawaírþjan	ɡ a w ɛ r θ j a n
gawaírþnan	ɡ a w ɛ r θ n a n
gawaknan	ɡ a w a k n a n
gawaldan	ɡ a w a l d a n
gawaleins	ɡ a w a l i n s
gawaljan	ɡ a w a l j a n
gawamms	ɡ a w a mː s
gawandeins	ɡ a w a n d i n s
gawandjan	ɡ a w a n d j a n
gawargeins	ɡ a w a r ɡ i n s
gawargjan	ɡ a w a r ɡ j a n
gawaseins	ɡ a w a s i n s
gawasjan	ɡ a w a s j a n
gawaúrdi	ɡ a w ɔ r d ɪ
gawaúrki	ɡ a w ɔ r k ɪ
gawaúrkjan	ɡ a w ɔ r k j a n
gawaúrstwa	ɡ a w ɔ r s t w a
gawaúrts	ɡ a w ɔ r t s
gaweihan	ɡ a w i h a n
gaweisōn	ɡ a w i s o n
gawēnjan	ɡ a w e n j a n
gawi	ɡ a w ɪ
gawidan	ɡ a w ɪ ð a n
gawigan	ɡ a w ɪ ɣ a n
gawiljis	ɡ a w ɪ l j ɪ s
gawindan	ɡ a w ɪ n d a n
gawinnan	ɡ a w ɪ nː a n
gawisan	ɡ a w ɪ s a n
gawiss	ɡ a w ɪ sː
gawitan	ɡ a w ɪ t a n
gawizneigs	ɡ a w ɪ z n i ɣ s
gawizns	ɡ a w ɪ z n̥ s
gawrikan	ɡ a w r ɪ k a n
gawrisqan	ɡ a w r ɪ s kʷ a n
gawundōn	ɡ a w u n d o n
gazaúflakiō	ɡ a z ɔ ɸ l a k ɪ o
gazds	ɡ a z d s
geen	ɡ e e n
geigan	ɡ i ɣ a n
geirō	ɡ i r o
geirs	ɡ i r s
geisls	ɡ i s l̥ s
geisnan	ɡ i s n a n
giba	ɡ ɪ β a
giban	ɡ ɪ β a n
gibands	ɡ ɪ β a n d s
gibla	ɡ ɪ β l a
gijan	ɡ ɪ j a n
gild	ɡ ɪ l d
gildan	ɡ ɪ l d a n
gilstr	ɡ ɪ l s t r̥
gilstramēleins	ɡ ɪ l s t r a m e l i n s
gilþa	ɡ ɪ l θ a
ginnan	ɡ ɪ nː a n
gisls	ɡ ɪ s l̥ s
gistradagis	ɡ ɪ s t r a ð a ɣ ɪ s
gitan	ɡ ɪ t a n
giutan	ɡ ɪ u t a n
glad	ɡ l a ð
glaggwaba	ɡ l a ɡ ɡ w a β a
glaggwō	ɡ l a ɡ ɡ w o
glaggws	ɡ l a ɡ ɡ w s
glaggwuba	ɡ l a ɡ ɡ w u β a
glitmuni	ɡ l ɪ t m u n ɪ
glitmunjan	ɡ l ɪ t m u n j a n
glōfa	ɡ l o ɸ a
gōdakunds	ɡ o ð a k u n d s
gōdei	ɡ o ð i
gōleins	ɡ o l i n s
gōljan	ɡ o l j a n
gōma	ɡ o m a
Goti	ɡ o t ɪ
Goþiscandza	ɡ o θ ɪ s c a n d z a
gōþs	ɡ o θ s
graba	ɡ r a β a
graban	ɡ r a β a n
grama	ɡ r a m a
gramjan	ɡ r a m j a n
grams	ɡ r a m s
gramst	ɡ r a m s t
grana	ɡ r a n a
granō	ɡ r a n o
granus	ɡ r a n u s
gras	ɡ r a s
Grautungōs	ɡ r ɔ t u n ɡ o s
grēdags	ɡ r e ð a ɣ s
grēdōn	ɡ r e ð o n
grēdus	ɡ r e ð u s
grēfan	ɡ r e ɸ a n
grēfts	ɡ r e ɸ t s
greima	ɡ r i m a
greipan	ɡ r i p a n
greiseis	ɡ r i s i s
Greotingi	ɡ r e o t ɪ n ɡ ɪ
grētan	ɡ r e t a n
grēts	ɡ r e t s
greut	ɡ r e u t
grēws	ɡ r e w s
grimman	ɡ r ɪ mː a n
grimmiþa	ɡ r ɪ mː ɪ θ a
grimms	ɡ r ɪ mː s
grindafraþjis	ɡ r ɪ n d a ɸ r a θ j ɪ s
grindan	ɡ r ɪ n d a n
grinds	ɡ r ɪ n d s
gris	ɡ r ɪ s
griþs	ɡ r ɪ θ s
Griutuggōs	ɡ r ɪ u t u ŋ ɡ o s
grōba	ɡ r o β a
grundiþa	ɡ r u n d ɪ θ a
grundus	ɡ r u n d u s
grunduwaddjus	ɡ r u n d u w a dː j u s
grūts	ɡ r u t s
Grūtungi	ɡ r u t u n ɡ ɪ
gudaba	ɡ u ð a β a
gudafaúrhts	ɡ u ð a ɸ ɔ r h t s
gudalaus	ɡ u ð a l ɔ s
gudaskaunei	ɡ u ð a s k ɔ n i
gudblōstreis	ɡ u ð b l o s t r i s
gudei	ɡ u ð i
gudhūs	ɡ u ð h u s
gudisks	ɡ u ð ɪ s k s
gudja	ɡ u ð j a
gudjinassus	ɡ u ð j ɪ n a sː u s
gudjinōn	ɡ u ð j ɪ n o n
gulþ	ɡ u l θ
gulþeins	ɡ u l θ i n s
guma	ɡ u m a
gumakunds	ɡ u m a k u n d s
gumein	ɡ u m i n
gumeins	ɡ u m i n s
gund	ɡ u n d
gunþi	ɡ u n θ ɪ
gunþs	ɡ u n θ s
Guta	ɡ u t a
Gutan	ɡ u t a n
gutisks	ɡ u t ɪ s k s
gutnan	ɡ u t n a n
Gutō	ɡ u t o
Gutþiuda	ɡ u t θ ɪ u ð a
guþ	ɡ u θ
haban	h a β a n
habands	h a β a n d s
hafjan	h a ɸ j a n
hafnan	h a ɸ n a n
haftjansik	h a ɸ t j a n s ɪ k
haftnan	h a ɸ t n a n
hafts	h a ɸ t s
hagja	h a ɣ j a
hagka	h a ŋ k a
hagl	h a ɣ l̥
hāh	h a h
hāhan	h a h a n
hāhjis	h a h j ɪ s
Haíbraius	h ɛ β r ɛ u s
haidus	h ɛ ð u s
haifstjan	h ɛ ɸ s t j a n
haifsts	h ɛ ɸ s t s
haihs	h ɛ h s
hailags	h ɛ l a ɣ s
haili	h ɛ l ɪ
hailisks	h ɛ l ɪ s k s
hailjan	h ɛ l j a n
hailnan	h ɛ l n a n
hails	h ɛ l s
haima	h ɛ m a
haimeis	h ɛ m i s
haimōþli	h ɛ m o θ l ɪ
haims	h ɛ m s
hairaíseis	h ɛ r ɛ s i s
haírda	h ɛ r d a
haírdeis	h ɛ r d i s
haírtō	h ɛ r t o
haírts	h ɛ r t s
haírþra	h ɛ r θ r a
haírus	h ɛ r u s
hais	h ɛ s
haitan	h ɛ t a n
haiti	h ɛ t ɪ
haitja	h ɛ t j a
haiþi	h ɛ θ ɪ
haiþiwisks	h ɛ θ ɪ w ɪ s k s
haiþnō	h ɛ θ n o
haiþns	h ɛ θ n̥ s
hakiljan	h a k ɪ l j a n
hakuls	h a k u l s
halba	h a l b a
halbs	h a l b s
haldan	h a l d a n
haldis	h a l d ɪ s
halis	h a l ɪ s
halisaiw	h a l ɪ s ɛ w
halja	h a l j a
haljōrūna	h a l j o r u n a
halks	h a l k s
hallus	h a lː u s
hals	h a l s
halsagga	h a l s a ŋ ɡ a
halts	h a l t s
halþei	h a l θ i
halþs	h a l θ s
hamfs	h a m ɸ s
hamōn	h a m o n
hams	h a m s
hana	h a n a
handa	h a n d a
handugei	h a n d u ɣ i
handugs	h a n d u ɣ s
handus	h a n d u s
handuwaúrhts	h a n d u w ɔ r h t s
hanō	h a n o
hansa	h a n s a
harbisjan	h a r b ɪ s j a n
harduba	h a r d u β a
harduhaírtei	h a r d u h ɛ r t i
harduhaírts	h a r d u h ɛ r t s
hardus	h a r d u s
haribaírgō	h a r ɪ β ɛ r ɡ o
hariggs	h a r ɪ ŋ ɡ s
harihriggs	h a r ɪ h r ɪ ŋ ɡ s
harjatuga	h a r j a t u ɣ a
harjis	h a r j ɪ s
harpa	h a r p a
harpōn	h a r p o n
haspa	h a s p a
haspan	h a s p a n
hasws	h a s w s
hatan	h a t a n
hatis	h a t ɪ s
hatizōn	h a t ɪ z o n
hatjan	h a t j a n
haþus	h a θ u s
haubiþ	h ɔ β ɪ θ
hauhaba	h ɔ h a β a
hauhei	h ɔ h i
hauheins	h ɔ h i n s
hauhhaírtei	h ɔ h h ɛ r t i
hauhhaírts	h ɔ h h ɛ r t s
hauhis	h ɔ h ɪ s
hauhisti	h ɔ h ɪ s t ɪ
hauhiþa	h ɔ h ɪ θ a
hauhjan	h ɔ h j a n
hauhnan	h ɔ h n a n
hauhs	h ɔ h s
hauhþūhts	h ɔ h θ u h t s
hauneins	h ɔ n i n s
hauniþa	h ɔ n ɪ θ a
haunjan	h ɔ n j a n
hauns	h ɔ n s
haúrds	h ɔ r d s
haúri	h ɔ r ɪ
haúrn	h ɔ r n̥
haúrnja	h ɔ r n j a
haúrnjan	h ɔ r n j a n
hauseins	h ɔ s i n s
hausjan	h ɔ s j a n
hausjōn	h ɔ s j o n
hawi	h a w ɪ
hazds	h a z d s
hazdwalds	h a z d w a l d s
hazeins	h a z i n s
hazer	h a z e r
hazjan	h a z j a n
heitō	h i t o
heits	h i t s
heiwa	h i w a
heiwafrauja	h i w a ɸ r ɔ j a
heiwiski	h i w ɪ s k ɪ
hēlei	h e l i
hēr	h e r
hēþjō	h e θ j o
hi	h ɪ
hidrē	h ɪ ð r e
hildi	h ɪ l d ɪ
hilds	h ɪ l d s
hilms	h ɪ l m̥ s
hilpan	h ɪ l p a n
himinakunds	h ɪ m ɪ n a k u n d s
himins	h ɪ m ɪ n s
hindana	h ɪ n d a n a
hindar	h ɪ n d a r
hindarleiþan	h ɪ n d a r l i θ a n
hindarweis	h ɪ n d a r w i s
hindarweisei	h ɪ n d a r w i s i
hindumists	h ɪ n d u m ɪ s t s
hinþan	h ɪ n θ a n
hiri	h ɪ r ɪ
hirjan	h ɪ r j a n
his	h ɪ s
hiufan	h ɪ u ɸ a n
hiuhma	h ɪ u h m a
hiwi	h ɪ w ɪ
hlahjan	h l a h j a n
hlaifs	h l ɛ ɸ s
hlain	h l ɛ n
hlaiw	h l ɛ w
hlaiwasnōs	h l ɛ w a s n o s
hlamma	h l a mː a
hlas	h l a s
hlasei	h l a s i
hlaþan	h l a θ a n
hlaupan	h l ɔ p a n
hlauts	h l ɔ t s
hleibjan	h l i β j a n
hleiduma	h l i ð u m a
hleiþra	h l i θ r a
hleþrastakeins	h l e θ r a s t a k i n s
hlifan	h l ɪ ɸ a n
hliftus	h l ɪ ɸ t u s
hlija	h l ɪ j a
hlimman	h l ɪ mː a n
hliuma	h l ɪ u m a
hliutan	h l ɪ u t a n
hliuþ	h l ɪ u θ
hlōhjan	h l o h j a n
hlūtrei	h l u t r i
hlūtriþa	h l u t r ɪ θ a
hlūtrs	h l u t r̥ s
hluþ	h l u θ
hnaiweins	h n ɛ w i n s
hnaiwjan	h n ɛ w j a n
hnaiws	h n ɛ w s
hnapps	h n a pː s
hnasqus	h n a s kʷ u s
hneipan	h n i p a n
hneiwan	h n i w a n
hnipnan	h n ɪ p n a n
hniupan	h n ɪ u p a n
hnupnan	h n u p n a n
hnuþō	h n u θ o
hōban	h o β a n
hōha	h o h a
hoka	h o k a
hōl	h o l
hōlōn	h o l o n
hōrinassus	h o r ɪ n a sː u s
hōrinōn	h o r ɪ n o n
hōrs	h o r s
hrabns	h r a β n̥ s
hrainei	h r ɛ n i
hraineins	h r ɛ n i n s
hrainiþa	h r ɛ n ɪ θ a
hrainjahaírts	h r ɛ n j a h ɛ r t s
hrainjan	h r ɛ n j a n
hrains	h r ɛ n s
hraiw	h r ɛ w
hraiwadūbō	h r ɛ w a ð u β o
hrama	h r a m a
hramjan	h r a m j a n
hranka	h r a n k a
hrankjan	h r a n k j a n
hrapōn	h r a p o n
hriggs	h r ɪ ŋ ɡ s
hrisjan	h r ɪ s j a n
hrōms	h r o m s
hrōpan	h r o p a n
hrōpjan	h r o p j a n
hrōps	h r o p s
hrōt	h r o t
hrōþ	h r o θ
hrōþeigs	h r o θ i ɣ s
hrugga	h r u ŋ ɡ a
hrūk	h r u k
hrūkjan	h r u k j a n
hrunkjan	h r u n k j a n
hruskan	h r u s k a n
hugds	h u ɣ d s
huggrjan	h u ŋ ɡ r j a n
hugjan	h u ɣ j a n
hugs	h u ɣ s
hūhjan	h u h j a n
hūhrus	h u h r u s
huleins	h u l i n s
hulistr	h u l ɪ s t r̥
huljan	h u l j a n
Hulmarugeis	h u l m a r u ɣ i s
hulms	h u l m̥ s
hulōn	h u l o n
huls	h u l s
hulþa	h u l θ a
hulþō	h u l θ o
hulþs	h u l θ s
hulundi	h u l u n d ɪ
hund	h u n d
hundafaþs	h u n d a ɸ a θ s
hunds	h u n d s
hūns	h u n s
hunsl	h u n s l̥
hunslags	h u n s l a ɣ s
hunslastaþs	h u n s l a s t a θ s
hunsljan	h u n s l j a n
hunþs	h u n θ s
hups	h u p s
hūs	h u s
husa	h u s a
huzd	h u z d
huzdjan	h u z d j a n
hwssōpō	h w sː o p o
ƕadrē	ʍ a ð r e
ƕair	ʍ ɛ r
ƕaírban	ʍ ɛ r b a n
ƕaírnei	ʍ ɛ r n i
ƕaírneins	ʍ ɛ r n i n s
ƕaírnō	ʍ ɛ r n o
ƕaiteis	ʍ ɛ t i s
ƕaiwa	ʍ ɛ w a
ƕan	ʍ a n
ƕanhun	ʍ a n h u n
ƕapjan	ʍ a p j a n
ƕapnan	ʍ a p n a n
ƕar	ʍ a r
ƕarbōn	ʍ a r b o n
ƕarjis	ʍ a r j ɪ s
ƕarjizuh	ʍ a r j ɪ z u h
ƕas	ʍ a s
ƕashun	ʍ a s h u n
ƕassaba	ʍ a sː a β a
ƕassei	ʍ a sː i
ƕatjan	ʍ a t j a n
ƕats	ʍ a t s
ƕaþ	ʍ a θ
ƕaþar	ʍ a θ a r
ƕaþaruh	ʍ a θ a r u h
ƕaþjan	ʍ a θ j a n
ƕaþō	ʍ a θ o
ƕaþrō	ʍ a θ r o
ƕazuh	ʍ a z u h
ƕē	ʍ e
ƕēh	ʍ e h
ƕeila	ʍ i l a
ƕeilaƕaírbs	ʍ i l a ʍ ɛ r b s
ƕeilains	ʍ i l ɛ n s
ƕeilan	ʍ i l a n
ƕeilōhun	ʍ i l o h u n
ƕeitags	ʍ i t a ɣ s
ƕeitjan	ʍ i t j a n
ƕeits	ʍ i t s
ƕēlauþs	ʍ e l ɔ θ s
ƕilban	ʍ ɪ l b a n
ƕileiks	ʍ ɪ l i k s
ƕilftri	ʍ ɪ l ɸ t r ɪ
ƕilftrjōs	ʍ ɪ l ɸ t r j o s
ƕōftuli	ʍ o ɸ t u l ɪ
ƕōpan	ʍ o p a n
ƕōta	ʍ o t a
ƕōtjan	ʍ o t j a n
ƕssōpō	ʍ sː o p o
ibai	ɪ β ɛ
ibdalja	ɪ β d a l j a
ibna	ɪ β n a
ibnaleiks	ɪ β n a l i k s
ibnaskauns	ɪ β n a s k ɔ n s
ibnassus	ɪ β n a sː u s
ibnatjan	ɪ β n a t j a n
ibnjan	ɪ β n j a n
ibnōn	ɪ β n o n
ibns	ɪ β n̥ s
ibrs	ɪ β r̥ s
ibuks	ɪ β u k s
iddja	ɪ dː j a
idreiga	ɪ ð r i ɣ a
idreigōn	ɪ ð r i ɣ o n
idreigs	ɪ ð r i ɣ s
idweit	ɪ ð w i t
idweitan	ɪ ð w i t a n
idweitjan	ɪ ð w i t j a n
iftuma	ɪ ɸ t u m a
igils	ɪ ɣ ɪ l s
igqar	ɪ ŋ kʷ a r
iiz	ɪ ɪ z
ik	ɪ k
ikei	ɪ k i
in	ɪ n
inagjan	ɪ n a ɣ j a n
inahei	ɪ n a h i
inahs	ɪ n a h s
inaljanōn	ɪ n a l j a n o n
inbrannjan	ɪ n b r a nː j a n
indrōbnan	ɪ n d r o β n a n
infeinan	ɪ n ɸ i n a n
ingaleikōn	ɪ n ɡ a l i k o n
ingardja	ɪ n ɡ a r d j a
ingif	ɪ n ɡ ɪ ɸ
ingramjan	ɪ n ɡ r a m j a n
ingrimjis	ɪ n ɡ r ɪ m j ɪ s
inilō	ɪ n ɪ l o
inilōn	ɪ n ɪ l o n
inkilþō	ɪ n k ɪ l θ o
inkunja	ɪ n k u n j a
inliuhtjan	ɪ n l ɪ u h t j a n
inmaideins	ɪ n m ɛ ð i n s
inmaidjan	ɪ n m ɛ ð j a n
inn	ɪ nː
inna	ɪ nː a
innakunds	ɪ nː a k u n d s
innana	ɪ nː a n a
innatbaíran	ɪ nː a t b ɛ r a n
innatgaggan	ɪ nː a t ɡ a ŋ ɡ a n
innatgāhts	ɪ nː a t ɡ a h t s
innattiuhan	ɪ nː a tː ɪ u h a n
innaþrō	ɪ nː a θ r o
inngaggan	ɪ nː ɣ a ŋ ɡ a n
inngaleiþan	ɪ nː ɣ a l i θ a n
inniman	ɪ nː ɪ m a n
inniujiþa	ɪ nː ɪ u j ɪ θ a
innufsliupan	ɪ nː u ɸ s l ɪ u p a n
innuma	ɪ nː u m a
innwaírpan	ɪ nː w ɛ r p a n
inraúhtjan	ɪ n r ɔ h t j a n
inreiran	ɪ n r i r a n
ins	ɪ n s
insahts	ɪ n s a h t s
insáian	ɪ n s ɛ a n
insaíƕan	ɪ n s ɛ ʍ a n
insailjan	ɪ n s ɛ l j a n
insakan	ɪ n s a k a n
insandjan	ɪ n s a n d j a n
instandan	ɪ n s t a n d a n
inswinþjan	ɪ n s w ɪ n θ j a n
intandjan	ɪ n t a n d j a n
intrusgjan	ɪ n t r u s ɡ j a n
intundnan	ɪ n t u n d n a n
inuh	ɪ n u h
inwagjan	ɪ n w a ɣ j a n
inwandjan	ɪ n w a n d j a n
inweitan	ɪ n w i t a n
inweitjan	ɪ n w i t j a n
inwidan	ɪ n w ɪ ð a n
inwindiþa	ɪ n w ɪ n d ɪ θ a
inwinds	ɪ n w ɪ n d s
inwisan	ɪ n w ɪ s a n
inwitōþs	ɪ n w ɪ t o θ s
iowi	ɪ o w ɪ
is	ɪ s
isks	ɪ s k s
Israēl	ɪ s r a e l
Israēleitēs	ɪ s r a e l i t e s
itan	ɪ t a n
iþ	ɪ θ
Iudaialand	ɪ u ð ɛ a l a n d
Iudaius	ɪ u ð ɛ u s
iudaiwiskō	ɪ u ð ɛ w ɪ s k o
iudaiwiskōn	ɪ u ð ɛ w ɪ s k o n
iudaiwisks	ɪ u ð ɛ w ɪ s k s
iumjō	ɪ u m j o
iup	ɪ u p
iupa	ɪ u p a
iupana	ɪ u p a n a
iupaþrō	ɪ u p a θ r o
ius	ɪ u s
iusila	ɪ u s ɪ l a
iusilōn	ɪ u s ɪ l o n
iusiza	ɪ u s ɪ z a
iuþa	ɪ u θ a
izei	ɪ z i
izwar	ɪ z w a r
ja	j a
jabai	j a β ɛ
jah	j a h
jai	j ɛ
jainar	j ɛ n a r
jaind	j ɛ n d
jaindrē	j ɛ n d r e
jaindwaírþs	j ɛ n d w ɛ r θ s
jains	j ɛ n s
jainþrō	j ɛ n θ r o
jaþþē	j a θː e
jau	j ɔ
jēr	j e r
Jesus	j e s u s
jiuka	j ɪ u k a
jiukan	j ɪ u k a n
Jiula	j ɪ u l a
jiuleis	j ɪ u l i s
jōta	j o t a
ju	j u
jūdaiwisks	j u ð ɛ w ɪ s k s
juggalauþs	j u ŋ ɡ a l ɔ θ s
juggs	j u ŋ ɡ s
juk	j u k
jukuzi	j u k u z ɪ
junda	j u n d a
jūs	j u s
jut	j u t
juþan	j u θ a n
jūzei	j u z i
kaìtàloipá	k ɛ t a l o ɪ p a
kaisar	k ɛ s a r
kaisaragild	k ɛ s a r a ɣ ɪ l d
kalb	k a l b
kalbō	k a l b o
kaldiggs	k a l d ɪ ŋ ɡ s
kalds	k a l d s
kalkinassus	k a l k ɪ n a sː u s
kalkinōn	k a l k ɪ n o n
kalkjō	k a l k j o
kanna	k a nː a
kannjan	k a nː j a n
kapillōn	k a p ɪ lː o n
kappōn	k a pː o n
kara	k a r a
karja	k a r j a
karkara	k a r k a r a
karōn	k a r o n
karpa	k a r p a
kart	k a r t
kas	k a s
kasja	k a s j a
katils	k a t ɪ l s
kaup	k ɔ p
kaupatjan	k ɔ p a t j a n
kaupōn	k ɔ p o n
kaúrban	k ɔ r b a n
kaúrbaúnas	k ɔ r b ɔ n a s
kaúrei	k ɔ r i
kaúreins	k ɔ r i n s
kaúriþa	k ɔ r ɪ θ a
kaúrjan	k ɔ r j a n
kaúrn	k ɔ r n̥
kaúrnō	k ɔ r n o
kaúrus	k ɔ r u s
kausjan	k ɔ s j a n
kawtsjō	k a w t s j o
keinan	k i n a n
kēlikn	k e l ɪ k n̥
kilan	k ɪ l a n
kilemschkop	k ɪ l e m s c h k o p
kilþ	k ɪ l θ
kilþei	k ɪ l θ i
kind	k ɪ n d
kindins	k ɪ n d ɪ n s
kinds	k ɪ n d s
kinnus	k ɪ nː u s
kintus	k ɪ n t u s
kiusan	k ɪ u s a n
klismjan	k l ɪ s m j a n
klismō	k l ɪ s m o
kluba	k l u β a
knawana	k n a w a n a
kniu	k n ɪ u
knōþs	k n o θ s
knussjan	k n u sː j a n
knussus	k n u sː u s
knutjan	k n u t j a n
kōka	k o k a
kōni	k o n ɪ
kop	k o p
kramjan	k r a m j a n
krampa	k r a m p a
krappa	k r a pː a
krattōn	k r a tː o n
kreitan	k r i t a n
kreitus	k r i t u s
Krēks	k r e k s
kripja	k r ɪ p j a
kriustan	k r ɪ u s t a n
krōtōn	k r o t o n
krūka	k r u k a
krukkja	k r u kː j a
kruppa	k r u pː a
krūska	k r u s k a
krūski	k r u s k ɪ
krusts	k r u s t s
kubitus	k u β ɪ t u s
kukjan	k u k j a n
kumei	k u m i
kunawida	k u n a w ɪ ð a
kundjan	k u n d j a n
kunds	k u n d s
kuni	k u n ɪ
kunnains	k u nː ɛ n s
kunnan	k u nː a n
kuns	k u n s
kunþi	k u n θ ɪ
kunþjan	k u n θ j a n
kunþs	k u n θ s
kuskeis	k u s k i s
kusma	k u s m a
kusts	k u s t s
kustus	k u s t u s
Kwreinaius	k w r i n ɛ u s
laggamōdei	l a ŋ ɡ a m o ð i
laggamōþs	l a ŋ ɡ a m o θ s
laggei	l a ŋ ɡ i
laggs	l a ŋ ɡ s
lagjan	l a ɣ j a n
lagus	l a ɣ u s
láian	l ɛ a n
laiba	l ɛ β a
laibjan	l ɛ β j a n
laidjan	l ɛ ð j a n
laif	l ɛ ɸ
laigaiōn	l ɛ ɣ ɛ o n
laigōn	l ɛ ɣ o n
laikan	l ɛ k a n
laiks	l ɛ k s
laíktjō	l ɛ k t j o
laisan	l ɛ s a n
laisāreis	l ɛ s a r i s
laiseigs	l ɛ s i ɣ s
laiseins	l ɛ s i n s
laisiþs	l ɛ s ɪ θ s
laisjan	l ɛ s j a n
laisō	l ɛ s o
laistjan	l ɛ s t j a n
laistōn	l ɛ s t o n
laists	l ɛ s t s
laiþs	l ɛ θ s
Laiwweitus	l ɛ wː i t u s
lamb	l a m b
lameis	l a m i s
land	l a n d
landjō	l a n d j o
lapins	l a p ɪ n s
lasiws	l a s ɪ w s
laska	l a s k a
latei	l a t i
latjan	l a t j a n
lats	l a t s
laþa	l a θ a
laþaleikō	l a θ a l i k o
laþaleiks	l a θ a l i k s
laþōn	l a θ o n
laþōns	l a θ o n s
laubei	l ɔ β i
laubja	l ɔ β j a
laubjan	l ɔ β j a n
laubjōlaubi	l ɔ β j o l ɔ β ɪ
laudi	l ɔ ð ɪ
laufs	l ɔ ɸ s
laugnjan	l ɔ ɣ n j a n
laugns	l ɔ ɣ n̥ s
lauhatjan	l ɔ h a t j a n
lauhmuni	l ɔ h m u n ɪ
laun	l ɔ n
launawargs	l ɔ n a w a r ɡ s
launi	l ɔ n ɪ
laus	l ɔ s
lausawaúrdei	l ɔ s a w ɔ r d i
lausawaúrdi	l ɔ s a w ɔ r d ɪ
lausawaúrds	l ɔ s a w ɔ r d s
lauseins	l ɔ s i n s
laushandja	l ɔ s h a n d j a
laushandus	l ɔ s h a n d u s
lausjan	l ɔ s j a n
lausqiþrei	l ɔ s kʷ ɪ θ r i
lausqiþrs	l ɔ s kʷ ɪ θ r̥ s
lauþs	l ɔ θ s
leihts	l i h t s
leiƕansis	l i ʍ a n s ɪ s
leik	l i k
leikains	l i k ɛ n s
leikan	l i k a n
leikei	l i k i
leikeins	l i k i n s
lein	l i n
leis	l i s
leisei	l i s i
leista	l i s t a
leitils	l i t ɪ l s
leiþan	l i θ a n
leiþu	l i θ u
lēkeis	l e k i s
lēkinassus	l e k ɪ n a sː u s
lēkinōn	l e k ɪ n o n
leodes	l e o ð e s
lēt	l e t
lētan	l e t a n
lētnan	l e t n a n
lēts	l e t s
leuba	l e u β a
leuda	l e u ð a
leudis	l e u ð ɪ s
lēw	l e w
lēwjan	l e w j a n
libains	l ɪ β ɛ n s
liban	l ɪ β a n
lif	l ɪ ɸ
lifnan	l ɪ ɸ n a n
lifs	l ɪ ɸ s
ligan	l ɪ ɣ a n
ligrs	l ɪ ɣ r̥ s
lima	l ɪ m a
lind	l ɪ n d
linda	l ɪ n d a
līs	l i s
lisan	l ɪ s a n
liska	l ɪ s k a
lista	l ɪ s t a
listeigs	l ɪ s t i ɣ s
lists	l ɪ s t s
lita	l ɪ t a
liteins	l ɪ t i n s
litjan	l ɪ t j a n
liþus	l ɪ θ u s
liubaleiks	l ɪ u β a l i k s
liudan	l ɪ u ð a n
liufs	l ɪ u ɸ s
liug	l ɪ u ɣ
liuga	l ɪ u ɣ a
liugaiþs	l ɪ u ɣ ɛ θ s
liugan	l ɪ u ɣ a n
liugands	l ɪ u ɣ a n d s
liugn	l ɪ u ɣ n̥
liugnapraufētus	l ɪ u ɣ n a p r ɔ ɸ e t u s
liugnawaúrds	l ɪ u ɣ n a w ɔ r d s
liugnja	l ɪ u ɣ n j a
liuhadei	l ɪ u h a ð i
liuhadeins	l ɪ u h a ð i n s
liuhaþ	l ɪ u h a θ
liuhtjan	l ɪ u h t j a n
liuhts	l ɪ u h t s
liusan	l ɪ u s a n
liuta	l ɪ u t a
liutei	l ɪ u t i
liuts	l ɪ u t s
liuþ	l ɪ u θ
liuþāreis	l ɪ u θ a r i s
liuþōn	l ɪ u θ o n
liuþs	l ɪ u θ s
liwa	l ɪ w a
lōfa	l o ɸ a
lōna	l o n a
lōþr	l o θ r̥
lubains	l u β ɛ n s
luban	l u β a n
lubi	l u β ɪ
lubjaleis	l u β j a l i s
lubjaleisei	l u β j a l i s i
lubō	l u β o
ludja	l u ð j a
lufeis	l u ɸ i s
luftus	l u ɸ t u s
luk	l u k
lūkan	l u k a n
lukarn	l u k a r n̥
lukarnastaþa	l u k a r n a s t a θ a
lūknan	l u k n a n
luneins	l u n i n s
lunjan	l u n j a n
luns	l u n s
lusnan	l u s n a n
lustōn	l u s t o n
lusts	l u s t s
lustus	l u s t u s
lustusama	l u s t u s a m a
lutōn	l u t o n
magan	m a ɣ a n
magaþei	m a ɣ a θ i
magaþs	m a ɣ a θ s
magula	m a ɣ u l a
magus	m a ɣ u s
mahteigs	m a h t i ɣ s
mahts	m a h t s
maideins	m ɛ ð i n s
maidjan	m ɛ ð j a n
maíhstus	m ɛ h s t u s
mail	m ɛ l
maímbrana	m ɛ m b r a n a
mains	m ɛ n s
mais	m ɛ s
maist	m ɛ s t
maists	m ɛ s t s
mait	m ɛ t
maitan	m ɛ t a n
maiþms	m ɛ θ m̥ s
maiþs	m ɛ θ s
maiza	m ɛ z a
maizō	m ɛ z o
mala	m a l a
malan	m a l a n
malma	m a l m a
malō	m a l o
malsks	m a l s k s
malteins	m a l t i n s
maltjan	m a l t j a n
malwjan	m a l w j a n
mammō	m a mː o
mammōna	m a mː o n a
man	m a n
managdūþs	m a n a ɣ d u θ s
managei	m a n a ɣ i
managfalþs	m a n a ɣ ɸ a l θ s
managjan	m a n a ɣ j a n
managnan	m a n a ɣ n a n
manags	m a n a ɣ s
manamaúrþrja	m a n a m ɔ r θ r j a
manariggws	m a n a r ɪ ɡ ɡ w s
manasēþs	m a n a s e θ s
manauli	m a n ɔ l ɪ
manleika	m a n l i k a
manna	m a nː a
mannahun	m a nː a h u n
manniskōdus	m a nː ɪ s k o ð u s
mannisks	m a nː ɪ s k s
manwiþa	m a n w ɪ θ a
manwjan	m a n w j a n
manwuba	m a n w u β a
manwus	m a n w u s
mar	m a r
maranaþa	m a r a n a θ a
marei	m a r i
marhs	m a r h s
marhskalks	m a r h s k a l k s
marikreitus	m a r ɪ k r i t u s
marisaiws	m a r ɪ s ɛ w s
marka	m a r k a
markōn	m a r k o n
martwr	m a r t w r̥
marþus	m a r θ u s
marzeins	m a r z i n s
marzjan	m a r z j a n
masts	m a s t s
matibalgs	m a t ɪ β a l ɡ s
matjan	m a t j a n
mats	m a t s
maþa	m a θ a
maþl	m a θ l̥
maþlei	m a θ l i
maþleis	m a θ l i s
maþljan	m a θ l j a n
maudjan	m ɔ ð j a n
mauiþs	m ɔ ɪ θ s
maukō	m ɔ k o
maur	m ɔ r
maúrgins	m ɔ r ɡ ɪ n s
maúrgjan	m ɔ r ɡ j a n
maúrgus	m ɔ r ɡ u s
maúrnan	m ɔ r n a n
maúrþr	m ɔ r θ r̥
maúrþrja	m ɔ r θ r j a
maúrþrjan	m ɔ r θ r j a n
mawi	m a w ɪ
mawilō	m a w ɪ l o
mēgs	m e ɣ s
meins	m i n s
mēki	m e k ɪ
mēl	m e l
mēla	m e l a
mēleins	m e l i n s
mēli	m e l ɪ
mēljan	m e l j a n
mēna	m e n a
mēnōþs	m e n o θ s
mēra	m e r a
mērei	m e r i
mēreins	m e r i n s
mēreis	m e r i s
mēriþa	m e r ɪ θ a
mērjan	m e r j a n
mērjands	m e r j a n d s
mērnan	m e r n a n
mēs	m e s
mēt	m e t
midgardiwaddjus	m ɪ ð ɡ a r d ɪ w a dː j u s
midjasweipains	m ɪ ð j a s w i p ɛ n s
midjis	m ɪ ð j ɪ s
midjungards	m ɪ ð j u n ɡ a r d s
miduma	m ɪ ð u m a
midumōn	m ɪ ð u m o n
midumōnds	m ɪ ð u m o n d s
midus	m ɪ ð u s
mikilaba	m ɪ k ɪ l a β a
mikildūþs	m ɪ k ɪ l d u θ s
mikilei	m ɪ k ɪ l i
mikiljan	m ɪ k ɪ l j a n
mikilnan	m ɪ k ɪ l n a n
mikils	m ɪ k ɪ l s
mikilþūhts	m ɪ k ɪ l θ u h t s
mildeis	m ɪ l d i s
mildiþa	m ɪ l d ɪ θ a
milhma	m ɪ l h m a
militōn	m ɪ l ɪ t o n
miliþ	m ɪ l ɪ θ
miltan	m ɪ l t a n
milti	m ɪ l t ɪ
miluks	m ɪ l u k s
mimz	m ɪ m z
minds	m ɪ n d s
minnists	m ɪ nː ɪ s t s
minniza	m ɪ nː ɪ z a
mins	m ɪ n s
minznan	m ɪ n z n a n
missa	m ɪ sː a
missadēþs	m ɪ sː a ð e θ s
missaleiks	m ɪ sː a l i k s
missaquiss	m ɪ sː a kʷ u ɪ sː
missataujan	m ɪ sː a t ɔ j a n
missō	m ɪ sː o
mitadjō	m ɪ t a ð j o
mitan	m ɪ t a n
mitaþs	m ɪ t a θ s
mitōn	m ɪ t o n
mitōns	m ɪ t o n s
miþ	m ɪ θ
miþanakumbjan	m ɪ θ a n a k u m b j a n
miþarbaidjan	m ɪ θ a r b ɛ ð j a n
miþfaginōn	m ɪ θ ɸ a ɣ ɪ n o n
miþfrahinþan	m ɪ θ ɸ r a h ɪ n θ a n
miþgadauþnan	m ɪ θ ɡ a ð ɔ θ n a n
miþgaggan	m ɪ θ ɡ a ŋ ɡ a n
miþgaleikōn	m ɪ θ ɡ a l i k o n
miþganawistrōn	m ɪ θ ɡ a n a w ɪ s t r o n
miþgaqiujan	m ɪ θ ɡ a kʷ ɪ u j a n
miþgasatjan	m ɪ θ ɡ a s a t j a n
miþgaswiltan	m ɪ θ ɡ a s w ɪ l t a n
miþgatimrjan	m ɪ θ ɡ a t ɪ m r j a n
miþgatiuhan	m ɪ θ ɡ a t ɪ u h a n
miþgawisan	m ɪ θ ɡ a w ɪ s a n
miþinngaleiþan	m ɪ θ ɪ nː ɣ a l i θ a n
miþinsandjan	m ɪ θ ɪ n s a n d j a n
miþkaúrjan	m ɪ θ k ɔ r j a n
miþliban	m ɪ θ l ɪ β a n
miþlitjan	m ɪ θ l ɪ t j a n
miþmatjan	m ɪ θ m a t j a n
miþniman	m ɪ θ n ɪ m a n
miþqiman	m ɪ θ kʷ ɪ m a n
miþqiþan	m ɪ θ kʷ ɪ θ a n
miþrōdjan	m ɪ θ r o ð j a n
miþsandjan	m ɪ θ s a n d j a n
miþsatjan	m ɪ θ s a t j a n
miþskalkinōn	m ɪ θ s k a l k ɪ n o n
miþsōkjan	m ɪ θ s o k j a n
miþstandan	m ɪ θ s t a n d a n
miþþan	m ɪ θː a n
miþþanei	m ɪ θː a n i
miþþiudanōn	m ɪ θː ɪ u ð a n o n
miþurraisjan	m ɪ θ u rː ɛ s j a n
miþurreisan	m ɪ θ u rː i s a n
miþushramjan	m ɪ θ u s h r a m j a n
miþuskeinan	m ɪ θ u s k i n a n
miþweitwōdjan	m ɪ θ w i t w o ð j a n
miþwisan	m ɪ θ w ɪ s a n
miþwiss	m ɪ θ w ɪ sː
miþwissei	m ɪ θ w ɪ sː i
miþwitan	m ɪ θ w ɪ t a n
mizdō	m ɪ z d o
mōdags	m o ð a ɣ s
mōjan	m o j a n
mōta	m o t a
mōtan	m o t a n
mōtāreis	m o t a r i s
mōtastaþs	m o t a s t a θ s
mōtjan	m o t j a n
mōþs	m o θ s
mudw	m u ð w
mudweins	m u ð w i n s
mugan	m u ɣ a n
muirjō	m u ɪ r j o
mūkamōdei	m u k a m o ð i
mūkamōþs	m u k a m o θ s
mūks	m u k s
mūlā	m u l a
mulda	m u l d a
muldeins	m u l d i n s
mulma	m u l m a
mūlus	m u l u s
munan	m u n a n
munda	m u n d a
mundōn	m u n d o n
mundrei	m u n d r i
mundrs	m u n d r̥ s
munds	m u n d s
munnōn	m u nː o n
muns	m u n s
munþs	m u n θ s
mūs	m u s
mūstriggs	m u s t r ɪ ŋ ɡ s
nadrs	n a ð r̥ s
nagljan	n a ɣ l j a n
nagls	n a ɣ l̥ s
nah	n a h
nahtamats	n a h t a m a t s
nahts	n a h t s
naiteins	n ɛ t i n s
naitjan	n ɛ t j a n
namnjan	n a m n j a n
namō	n a m o
nanþ	n a n θ
nanþjan	n a n θ j a n
nanþs	n a n θ s
naqadei	n a kʷ a ð i
naqaþs	n a kʷ a θ s
nardus	n a r d u s
naseins	n a s i n s
nasjan	n a s j a n
nasjands	n a s j a n d s
nastilō	n a s t ɪ l o
nati	n a t ɪ
natjan	n a t j a n
nats	n a t s
nauan	n ɔ a n
naubaimbair	n ɔ β ɛ m b ɛ r
naudibandi	n ɔ ð ɪ β a n d ɪ
naudiþaúrfts	n ɔ ð ɪ θ ɔ r ɸ t s
naúh	n ɔ h
naúha	n ɔ h a
naúhan	n ɔ h a n
naúhþan	n ɔ h θ a n
naúhþanuh	n ɔ h θ a n u h
naúhuþþan	n ɔ h u θː a n
naúrþs	n ɔ r θ s
naus	n ɔ s
nauþjan	n ɔ θ j a n
nauþs	n ɔ θ s
nawis	n a w ɪ s
nawistr	n a w ɪ s t r̥
nawistrōn	n a w ɪ s t r o n
nawiswaran	n a w ɪ s w a r a n
ne	n e
nēdrō	n e ð r o
nēƕ	n e ʍ
nēƕa	n e ʍ a
nēƕis	n e ʍ ɪ s
nēƕjansik	n e ʍ j a n s ɪ k
nēƕundi	n e ʍ u n d ɪ
nēƕundja	n e ʍ u n d j a
nei	n i
neiþ	n i θ
neiwan	n i w a n
nēm	n e m
nēmeigs	n e m i ɣ s
nēms	n e m s
nēþla	n e θ l a
ni	n ɪ
nibai	n ɪ β ɛ
nidwa	n ɪ ð w a
nih	n ɪ h
niman	n ɪ m a n
nisan	n ɪ s a n
nists	n ɪ s t s
niþan	n ɪ θ a n
niþjis	n ɪ θ j ɪ s
niþjō	n ɪ θ j o
niþþan	n ɪ θː a n
niu	n ɪ u
niuhseins	n ɪ u h s i n s
niuhsjan	n ɪ u h s j a n
niujan	n ɪ u j a n
niujasatiþs	n ɪ u j a s a t ɪ θ s
niujis	n ɪ u j ɪ s
niujiþa	n ɪ u j ɪ θ a
niuklahei	n ɪ u k l a h i
niuklahs	n ɪ u k l a h s
niun	n ɪ u n
niunda	n ɪ u n d a
niungeldo	n ɪ u n ɡ e l d o
niuntēhund	n ɪ u n t e h u n d
niutan	n ɪ u t a n
niuþs	n ɪ u θ s
nōhjan	n o h j a n
nōhnan	n o h n a n
nōhs	n o h s
noicz	n o ɪ c z
nōta	n o t a
nū	n u
nūh	n u h
numja	n u m j a
numts	n u m t s
nūnū	n u n u
nuta	n u t a
nuts	n u t s
ō	o
ofts	o ɸ t s
ōgan	o ɣ a n
ōgjan	o ɣ j a n
ōsanna	o s a nː a
Ostrogoþi	o s t r o ɣ o θ ɪ
ōþal	o θ a l
ōþli	o θ l ɪ
paida	p ɛ ð a
paidōn	p ɛ ð o n
paíntēdags	p ɛ n t e ð a ɣ s
paíntēkustē	p ɛ n t e k u s t e
paírþra	p ɛ r θ r a
papa	p a p a
paraklētus	p a r a k l e t u s
paraskaíwē	p a r a s k ɛ w e
pareinsdags	p a r i n s d a ɣ s
parra	p a rː a
paska	p a s k a
paúrpura	p ɔ r p u r a
paúrpurōn	p ɔ r p u r o n
paúrpurōþs	p ɔ r p u r o θ s
pauta	p ɔ t a
peika	p i k a
peikabagms	p i k a β a ɣ m̥ s
pistikeins	p ɪ s t ɪ k i n s
plapja	p l a p j a
plat	p l a t
plinsjan	p l ɪ n s j a n
plōgs	p l o ɣ s
pragga	p r a ŋ ɡ a
praggan	p r a ŋ ɡ a n
praitōriaún	p r ɛ t o r ɪ ɔ n
praízbwtaírei	p r ɛ z b w t ɛ r i
praúfēteis	p r ɔ ɸ e t i s
praúfētes	p r ɔ ɸ e t e s
praúfētja	p r ɔ ɸ e t j a
praúfētjan	p r ɔ ɸ e t j a n
psalmō	p s a l m o
puggs	p u ŋ ɡ s
pund	p u n d
qainōn	kʷ ɛ n o n
qaírnus	kʷ ɛ r n u s
qaírrei	kʷ ɛ rː i
qaírrus	kʷ ɛ rː u s
qaírþra	kʷ ɛ r θ r a
qaíru	kʷ ɛ r u
qaiwjan	kʷ ɛ w j a n
qēniþs	kʷ e n ɪ θ s
qēnjan	kʷ e n j a n
qēns	kʷ e n s
qēþs	kʷ e θ s
qidi	kʷ ɪ ð ɪ
qilan	kʷ ɪ l a n
qiman	kʷ ɪ m a n
qinakunds	kʷ ɪ n a k u n d s
qinein	kʷ ɪ n i n
qineins	kʷ ɪ n i n s
qinō	kʷ ɪ n o
qiss	kʷ ɪ sː
qisteins	kʷ ɪ s t i n s
qistjan	kʷ ɪ s t j a n
qistnan	kʷ ɪ s t n a n
qists	kʷ ɪ s t s
qiþan	kʷ ɪ θ a n
qiþr	kʷ ɪ θ r̥
qiþuhaftō	kʷ ɪ θ u h a ɸ t o
qiþuhafts	kʷ ɪ θ u h a ɸ t s
qiþus	kʷ ɪ θ u s
qiujan	kʷ ɪ u j a n
qiunan	kʷ ɪ u n a n
qius	kʷ ɪ u s
qrammiþa	kʷ r a mː ɪ θ a
qramms	kʷ r a mː s
qums	kʷ u m s
qumþs	kʷ u m θ s
rabbaúnei	r a bː ɔ n i
rabbei	r a bː i
ragin	r a ɣ ɪ n
ragineis	r a ɣ ɪ n i s
ragini	r a ɣ ɪ n ɪ
raginōn	r a ɣ ɪ n o n
ragins	r a ɣ ɪ n s
rahna	r a h n a
rahnjan	r a h n j a n
rahtōn	r a h t o n
raida	r ɛ ð a
raideins	r ɛ ð i n s
raidjan	r ɛ ð j a n
raíhtaba	r ɛ h t a β a
raíhtei	r ɛ h t i
raíhteins	r ɛ h t i n s
raíhtis	r ɛ h t ɪ s
raíhtiþa	r ɛ h t ɪ θ a
raíhtjan	r ɛ h t j a n
raíhts	r ɛ h t s
raip	r ɛ p
raisjan	r ɛ s j a n
raiþs	r ɛ θ s
rak	r a k
raka	r a k a
rakjan	r a k j a n
ram	r a m
rampa	r a m p a
ran	r a n
randa	r a n d a
randus	r a n d u s
ranneins	r a nː i n s
rannjan	r a nː j a n
rapōn	r a p o n
rappa	r a pː a
rasa	r a s a
rasta	r a s t a
raþan	r a θ a n
raþjan	r a θ j a n
raþjō	r a θ j o
raþs	r a θ s
rauba	r ɔ β a
raubōn	r ɔ β o n
raúhtjan	r ɔ h t j a n
raupa	r ɔ p a
raupjan	r ɔ p j a n
raus	r ɔ s
rausa	r ɔ s a
raustjan	r ɔ s t j a n
rauþs	r ɔ θ s
razda	r a z d a
razn	r a z n̥
razzjan	r a zː j a n
rēdan	r e ð a n
rēhsns	r e h s n̥ s
reidan	r i ð a n
reikeis	r i k i s
reiki	r i k ɪ
reikinōn	r i k ɪ n o n
reiks	r i k s
reiran	r i r a n
reirō	r i r o
reisan	r i s a n
rēþs	r e θ s
ribja	r ɪ β j a
rift	r ɪ ɸ t
rigilō	r ɪ ɣ ɪ l o
rign	r ɪ ɣ n̥
rignjan	r ɪ ɣ n j a n
rikan	r ɪ k a n
rimis	r ɪ m ɪ s
rinnan	r ɪ nː a n
rinnō	r ɪ nː o
rintsch	r ɪ n t s c h
riqis	r ɪ kʷ ɪ s
riqizeins	r ɪ kʷ ɪ z i n s
riqizjan	r ɪ kʷ ɪ z j a n
rists	r ɪ s t s
riuban	r ɪ u β a n
riudan	r ɪ u ð a n
riudei	r ɪ u ð i
riudi	r ɪ u ð ɪ
riurei	r ɪ u r i
riureis	r ɪ u r i s
riurjan	r ɪ u r j a n
rōdeins	r o ð i n s
rōdjan	r o ð j a n
rōhsns	r o h s n̥ s
Rugeis	r u ɣ i s
rugi	r u ɣ ɪ
rukka	r u kː a
rūm	r u m
Rūma	r u m a
rūman	r u m a n
rūmnan	r u m n a n
Rūmōneis	r u m o n i s
rūms	r u m s
rūna	r u n a
rūni	r u n ɪ
runjō	r u n j o
runs	r u n s
rupatjan	r u p a t j a n
rus	r u s
rusma	r u s m a
sa	s a
saba	s a β a
saban	s a β a n
sabbatō	s a bː a t o
sada	s a ð a
Saddukaieis	s a dː u k ɛ i s
saei	s a i
sag	s a ɣ
saggqjan	s a ŋ ɡ kʷ j a n
saggqs	s a ŋ ɡ kʷ s
saggws	s a ɡ ɡ w s
sagja	s a ɣ j a
sagjis	s a ɣ j ɪ s
sah	s a h
sahrja	s a h r j a
sahs	s a h s
sahtaba	s a h t a β a
sahts	s a h t s
saƕazuh	s a ʍ a z u h
sai	s ɛ
sáian	s ɛ a n
saíhs	s ɛ h s
saíhsta	s ɛ h s t a
saíƕan	s ɛ ʍ a n
sail	s ɛ l
sailjan	s ɛ l j a n
sainjan	s ɛ n j a n
sainus	s ɛ n u s
saio	s ɛ o
sair	s ɛ r
saiwala	s ɛ w a l a
saiws	s ɛ w s
sakan	s a k a n
sakjō	s a k j o
sakkus	s a kː u s
sakuls	s a k u l s
salba	s a l b a
salbōn	s a l b o n
salbōns	s a l b o n s
saldra	s a l d r a
saliþwa	s a l ɪ θ w a
saljan	s a l j a n
sals	s a l s
salt	s a l t
saltan	s a l t a n
saltans	s a l t a n s
salwa	s a l w a
sama	s a m a
samafraþjis	s a m a ɸ r a θ j ɪ s
samakuns	s a m a k u n s
samalauþs	s a m a l ɔ θ s
samaleikō	s a m a l i k o
samaleiks	s a m a l i k s
samana	s a m a n a
samaqiss	s a m a kʷ ɪ sː
Samareitēs	s a m a r i t e s
samasaiwals	s a m a s ɛ w a l s
samaþ	s a m a θ
samjan	s a m j a n
sanda	s a n d a
sandjan	s a n d j a n
sanþs	s a n θ s
sarwa	s a r w a
sateins	s a t i n s
satiþs	s a t ɪ θ s
satjan	s a t j a n
saþs	s a θ s
saúhts	s ɔ h t s
sáuil	s ɔ ɪ l
sauleins	s ɔ l i n s
sauljan	s ɔ l j a n
sauljō	s ɔ l j o
saulnan	s ɔ l n a n
sauls	s ɔ l s
Saúr	s ɔ r
saúrga	s ɔ r ɡ a
saúrgan	s ɔ r ɡ a n
Saúrini	s ɔ r ɪ n ɪ
Saúrja	s ɔ r j a
saurjan	s ɔ r j a n
sauþa	s ɔ θ a
sauþs	s ɔ θ s
scancia	s c a n c ɪ a
scaptus	s c a p t u s
schediit	s c h e ð ɪ ɪ t
scrama	s c r a m a
Seidoneis	s i ð o n i s
seil	s i l
seinagaírns	s i n a ɣ ɛ r n̥ s
seins	s i n s
seiteins	s i t i n s
seiþs	s i θ s
seiþus	s i θ u s
sēlei	s e l i
sēls	s e l s
sēti	s e t ɪ
sēþs	s e θ s
sibakþani	s ɪ β a k θ a n ɪ
sibja	s ɪ β j a
sibjis	s ɪ β j ɪ s
sibjōn	s ɪ β j o n
sibun	s ɪ β u n
sibunda	s ɪ β u n d a
sibuntēhund	s ɪ β u n t e h u n d
sidōnsis	s ɪ ð o n s ɪ s
sidus	s ɪ ð u s
sifan	s ɪ ɸ a n
siggwan	s ɪ ɡ ɡ w a n
sigis	s ɪ ɣ ɪ s
sigislaun	s ɪ ɣ ɪ s l ɔ n
sigljan	s ɪ ɣ l j a n
sigljō	s ɪ ɣ l j o
sigqan	s ɪ ŋ kʷ a n
sigus	s ɪ ɣ u s
sik	s ɪ k
sikls	s ɪ k l̥ s
silan	s ɪ l a n
silba	s ɪ l b a
silbasiuneis	s ɪ l b a s ɪ u n i s
silbawiljis	s ɪ l b a w ɪ l j ɪ s
silda	s ɪ l d a
sildaleik	s ɪ l d a l i k
sildaleikjan	s ɪ l d a l i k j a n
sildaleiknan	s ɪ l d a l i k n a n
sildaleiks	s ɪ l d a l i k s
silubr	s ɪ l u β r̥
silubreins	s ɪ l u β r i n s
simlē	s ɪ m l e
sinaps	s ɪ n a p s
sineigs	s ɪ n i ɣ s
siniskalks	s ɪ n ɪ s k a l k s
sins	s ɪ n s
sinteinō	s ɪ n t i n o
sinteins	s ɪ n t i n s
sinþan	s ɪ n θ a n
sinþs	s ɪ n θ s
sipōneis	s ɪ p o n i s
sipōnjan	s ɪ p o n j a n
sis	s ɪ s
sisi	s ɪ s ɪ
sitan	s ɪ t a n
sitls	s ɪ t l̥ s
siudan	s ɪ u ð a n
siujan	s ɪ u j a n
siukan	s ɪ u k a n
siukei	s ɪ u k i
siuks	s ɪ u k s
siuneis	s ɪ u n i s
siuniba	s ɪ u n ɪ β a
siuns	s ɪ u n s
siurjō	s ɪ u r j o
skaban	s k a β a n
skadus	s k a ð u s
skadweins	s k a ð w i n s
skadwjan	s k a ð w j a n
skaftjansik	s k a ɸ t j a n s ɪ k
skafts	s k a ɸ t s
skagkja	s k a ŋ k j a
skagkjan	s k a ŋ k j a n
skaidan	s k ɛ ð a n
skaideins	s k ɛ ð i n s
skaidnan	s k ɛ ð n a n
skaírmjan	s k ɛ r m j a n
skaírnjan	s k ɛ r n j a n
skairpa	s k ɛ r p a
skalja	s k a l j a
skalkinassus	s k a l k ɪ n a sː u s
skalkinōn	s k a l k ɪ n o n
skalks	s k a l k s
skama	s k a m a
skamansik	s k a m a n s ɪ k
skanda	s k a n d a
skapja	s k a p j a
skapjan	s k a p j a n
skapt	s k a p t
skarda	s k a r d a
skarja	s k a r j a
skarjan	s k a r j a n
skarpa	s k a r p a
skattja	s k a tː j a
skatts	s k a tː s
skaþaliggs	s k a θ a l ɪ ŋ ɡ s
skaþis	s k a θ ɪ s
skaþjan	s k a θ j a n
skaþuls	s k a θ u l s
skaudaraip	s k ɔ ð a r ɛ p
skaunei	s k ɔ n i
skauns	s k ɔ n s
skaúrō	s k ɔ r o
skaúrpjō	s k ɔ r p j o
skauts	s k ɔ t s
skeima	s k i m a
skeinan	s k i n a n
skeireins	s k i r i n s
skeirja	s k i r j a
skeirjan	s k i r j a n
skeirs	s k i r s
skeitan	s k i t a n
skēwjan	s k e w j a n
skildus	s k ɪ l d u s
skilja	s k ɪ l j a
skilla	s k ɪ lː a
skilliggs	s k ɪ lː ɪ ŋ ɡ s
skip	s k ɪ p
skiuban	s k ɪ u β a n
skiutan	s k ɪ u t a n
skōhs	s k o h s
skōhsl	s k o h s l̥
skorr	s k o rː
skorristr	s k o rː ɪ s t r̥
skramma	s k r a mː a
skreitan	s k r i t a n
skritnan	s k r ɪ t n a n
skuft	s k u ɸ t
skuggwa	s k u ɡ ɡ w a
skula	s k u l a
skulan	s k u l a n
skuld	s k u l d
skuldō	s k u l d o
skulka	s k u l k a
skūms	s k u m s
skuppa	s k u pː a
skūra	s k u r a
Skwþus	s k w θ u s
slahals	s l a h a l s
slahan	s l a h a n
slahs	s l a h s
slahta	s l a h t a
slaíhts	s l ɛ h t s
slaufa	s l ɔ ɸ a
slaúhts	s l ɔ h t s
slaupjan	s l ɔ p j a n
slawan	s l a w a n
slawiþa	s l a w ɪ θ a
sleipan	s l i p a n
sleipjan	s l i p j a n
sleiþa	s l i θ a
sleiþei	s l i θ i
sleiþjan	s l i θ j a n
sleiþs	s l i θ s
slēpan	s l e p a n
slēps	s l e p s
slimbs	s l ɪ m b s
slindan	s l ɪ n d a n
slipjan	s l ɪ p j a n
slitjan	s l ɪ t j a n
sliupan	s l ɪ u p a n
smaírþr	s m ɛ r θ r̥
smakka	s m a kː a
smakkabagms	s m a kː a β a ɣ m̥ s
smals	s m a l s
smaltjan	s m a l t j a n
smalts	s m a l t s
smarna	s m a r n a
smeitan	s m i t a n
smikwa	s m ɪ k w a
smiþa	s m ɪ θ a
smiþōn	s m ɪ θ o n
smiþs	s m ɪ θ s
smiugan	s m ɪ u ɣ a n
smwrn	s m w r n̥
snaga	s n a ɣ a
snaírpan	s n ɛ r p a n
snaiws	s n ɛ w s
snarpjan	s n a r p j a n
sneiþan	s n i θ a n
sneiwan	s n i w a n
snills	s n ɪ lː s
snippa	s n ɪ pː a
sniumjan	s n ɪ u m j a n
sniums	s n ɪ u m s
sniumundō	s n ɪ u m u n d o
sniwan	s n ɪ w a n
snōbō	s n o β o
snōrjō	s n o r j o
snōrs	s n o r s
snutrei	s n u t r i
snutrs	s n u t r̥ s
snuzō	s n u z o
sōkāreis	s o k a r i s
sōkeins	s o k i n s
sōkja	s o k j a
sōkjan	s o k j a n
sōkns	s o k n̥ s
sōks	s o k s
sōna	s o n a
sōþ	s o θ
sōþjan	s o θ j a n
spadingus	s p a ð ɪ n ɡ u s
spaíha	s p ɛ h a
spaíhōn	s p ɛ h o n
spaíkulatur	s p ɛ k u l a t u r
spaiskuldr	s p ɛ s k u l d r̥
sparra	s p a rː a
sparuks	s p a r u k s
sparwa	s p a r w a
sparwāreis	s p a r w a r i s
spaúra	s p ɔ r a
spaúrds	s p ɔ r d s
spēdiza	s p e ð ɪ z a
speiwan	s p i w a n
spēþs	s p e θ s
speuts	s p e u t s
spilda	s p ɪ l d a
spill	s p ɪ lː
spilla	s p ɪ lː a
spillōn	s p ɪ lː o n
spinnan	s p ɪ nː a n
spitus	s p ɪ t u s
spiuts	s p ɪ u t s
spōla	s p o l a
sprautō	s p r ɔ t o
spriutan	s p r ɪ u t a n
spwreida	s p w r i ð a
stadjan	s t a ð j a n
stafs	s t a ɸ s
stagga	s t a ŋ ɡ a
staggan	s t a ŋ ɡ a n
stagqjan	s t a ŋ kʷ j a n
staiga	s t ɛ ɣ a
stainahs	s t ɛ n a h s
staineins	s t ɛ n i n s
stainjan	s t ɛ n j a n
stains	s t ɛ n s
staírnō	s t ɛ r n o
staírō	s t ɛ r o
staka	s t a k a
stakeins	s t a k i n s
stakjan	s t a k j a n
stakkōn	s t a kː o n
staks	s t a k s
stald	s t a l d
staldan	s t a l d a n
stalds	s t a l d s
stalla	s t a lː a
stamms	s t a mː s
stampa	s t a m p a
stampjan	s t a m p j a n
stampōn	s t a m p o n
standan	s t a n d a n
stap	s t a p
starks	s t a r k s
stasseis	s t a sː i s
staþa	s t a θ a
staþjis	s t a θ j ɪ s
staþs	s t a θ s
stáua	s t ɔ a
stáuastōls	s t ɔ a s t o l s
staúrknan	s t ɔ r k n a n
staúrmjan	s t ɔ r m j a n
staúrms	s t ɔ r m̥ s
staúrran	s t ɔ rː a n
stautan	s t ɔ t a n
stega	s t e ɣ a
steigan	s t i ɣ a n
stibna	s t ɪ β n a
stiga	s t ɪ ɣ a
stiggils	s t ɪ ŋ ɡ ɪ l s
stigqan	s t ɪ ŋ kʷ a n
stika	s t ɪ k a
stikan	s t ɪ k a n
stikils	s t ɪ k ɪ l s
stikls	s t ɪ k l̥ s
stiks	s t ɪ k s
stilan	s t ɪ l a n
stiur	s t ɪ u r
stiurei	s t ɪ u r i
stiuri	s t ɪ u r ɪ
stiuriba	s t ɪ u r ɪ β a
stiurjan	s t ɪ u r j a n
stiurs	s t ɪ u r s
stiwiti	s t ɪ w ɪ t ɪ
stōdeins	s t o ð i n s
stōjan	s t o j a n
stōls	s t o l s
stōma	s t o m a
stōþan	s t o θ a n
stōþs	s t o θ s
strappōn	s t r a pː o n
strau	s t r ɔ
straujan	s t r ɔ j a n
straupjan	s t r ɔ p j a n
straupōn	s t r ɔ p o n
strava	s t r a v a
streikan	s t r i k a n
strigga	s t r ɪ ŋ ɡ a
striks	s t r ɪ k s
stubjus	s t u β j u s
stuggjan	s t u ŋ ɡ j a n
stuggq	s t u ŋ ɡ kʷ
stuggs	s t u ŋ ɡ s
stunda	s t u n d a
stūriliggs	s t u r ɪ l ɪ ŋ ɡ s
stutja	s t u t j a
stuþjan	s t u θ j a n
sugil	s u ɣ ɪ l
sulja	s u l j a
sūljan	s u l j a n
suman	s u m a n
sums	s u m s
sundi	s u n d ɪ
sundrō	s u n d r o
sunja	s u n j a
sunjaba	s u n j a β a
sunjeins	s u n j i n s
sunjis	s u n j ɪ s
sunjōn	s u n j o n
sunjōns	s u n j o n s
sunnō	s u nː o
suns	s u n s
sunsaiw	s u n s ɛ w
sunsei	s u n s i
sunþar	s u n θ a r
sunus	s u n u s
sūpa	s u p a
sūpan	s u p a n
supōn	s u p o n
suppa	s u pː a
suppōn	s u pː o n
suqn	s u kʷ n
suqnan	s u kʷ n a n
sūs	s u s
sūti	s u t ɪ
sūtis	s u t ɪ s
suþjan	s u θ j a n
suþjōn	s u θ j o n
swa	s w a
swaei	s w a i
swaggwjan	s w a ɡ ɡ w j a n
swah	s w a h
swaíhra	s w ɛ h r a
swaíhrō	s w ɛ h r o
swaírban	s w ɛ r b a n
swalauþs	s w a l ɔ θ s
swaleiks	s w a l i k s
swalleins	s w a lː i n s
swalljan	s w a lː j a n
swamms	s w a mː s
swans	s w a n s
swara	s w a r a
swaran	s w a r a n
swarē	s w a r e
swartis	s w a r t ɪ s
swartizl	s w a r t ɪ z l̥
swartjan	s w a r t j a n
swarts	s w a r t s
swaswē	s w a s w e
swaþþan	s w a θː a n
swau	s w ɔ
swē	s w e
Swēbōs	s w e β o s
swēgniþa	s w e ɣ n ɪ θ a
swēgnjan	s w e ɣ n j a n
swēgns	s w e ɣ n̥ s
sweiban	s w i β a n
sweibands	s w i β a n d s
swein	s w i n
sweins	s w i n s
sweipains	s w i p ɛ n s
sweipan	s w i p a n
Swēōs	s w e o s
swēran	s w e r a n
swērei	s w e r i
swēriþa	s w e r ɪ θ a
swērs	s w e r s
swēs	s w e s
swēþauh	s w e θ ɔ h
swibls	s w ɪ β l̥ s
swiggwan	s w ɪ ɡ ɡ w a n
swigl	s w ɪ ɣ l̥
swiglja	s w ɪ ɣ l j a
swiglōn	s w ɪ ɣ l o n
swiknaba	s w ɪ k n a β a
swiknei	s w ɪ k n i
swikneins	s w ɪ k n i n s
swikniþa	s w ɪ k n ɪ θ a
swiknjan	s w ɪ k n j a n
swikns	s w ɪ k n̥ s
swikunþaba	s w ɪ k u n θ a β a
swikunþjan	s w ɪ k u n θ j a n
swikunþs	s w ɪ k u n θ s
swillan	s w ɪ lː a n
swiltan	s w ɪ l t a n
swimman	s w ɪ mː a n
swinþei	s w ɪ n θ i
swinþjan	s w ɪ n θ j a n
swinþnan	s w ɪ n θ n a n
swinþs	s w ɪ n θ s
swistar	s w ɪ s t a r
swnagōgafaþs	s w n a ɣ o ɣ a ɸ a θ s
swnagōgē	s w n a ɣ o ɣ e
swōgan	s w o ɣ a n
swōgatjan	s w o ɣ a t j a n
swōgjan	s w o ɣ j a n
swōgs	s w o ɣ s
swultawaírþja	s w u l t a w ɛ r θ j a
swultawaírþs	s w u l t a w ɛ r θ s
swults	s w u l t s
swumfsl	s w u m ɸ s l̥
taban	t a β a n
taddora	t a dː o r a
tagl	t a ɣ l̥
tagr	t a ɣ r̥
tagrjan	t a ɣ r j a n
tahanjan	t a h a n j a n
taheins	t a h i n s
tahjan	t a h j a n
tāhus	t a h u s
taíhswa	t ɛ h s w a
taíhun	t ɛ h u n
taíhunda	t ɛ h u n d a
taíhuntaíhundfalþs	t ɛ h u n t ɛ h u n d ɸ a l θ s
taíhuntēhund	t ɛ h u n t e h u n d
taíhuntēweis	t ɛ h u n t e w i s
taikn	t ɛ k n̥
taikneins	t ɛ k n i n s
taiknjan	t ɛ k n j a n
taikns	t ɛ k n̥ s
tainjō	t ɛ n j o
tains	t ɛ n s
taíran	t ɛ r a n
Taírwiggōs	t ɛ r w ɪ ŋ ɡ o s
taítrarkēs	t ɛ t r a r k e s
taleiþa	t a l i θ a
talōn	t a l o n
tals	t a l s
talzeins	t a l z i n s
talzjan	t a l z j a n
talzjands	t a l z j a n d s
tamjan	t a m j a n
tams	t a m s
tandjan	t a n d j a n
tappa	t a pː a
tarhjan	t a r h j a n
tarmjan	t a r m j a n
tarnjan	t a r n j a n
taskōn	t a s k o n
taturō	t a t u r o
taúhts	t ɔ h t s
táui	t ɔ ɪ
taujan	t ɔ j a n
taujands	t ɔ j a n d s
taúra	t ɔ r a
taúrnan	t ɔ r n a n
taúrþs	t ɔ r θ s
tē	t e
tēhund	t e h u n d
teihan	t i h a n
tēkan	t e k a n
telich	t e l ɪ c h
tēlōn	t e l o n
tēmiba	t e m ɪ β a
tēms	t e m s
Tērvingi	t e r v ɪ n ɡ ɪ
tēwa	t e w a
tēweis	t e w i s
tēwjan	t e w j a n
the	t h e
thīnita	t h i n ɪ t a
thīntria	t h i n t r ɪ a
thīntua	t h i n t u a
tibr	t ɪ β r̥
tigjus	t ɪ ɣ j u s
tilamalsks	t ɪ l a m a l s k s
tilarēþs	t ɪ l a r e θ s
tilōn	t ɪ l o n
tils	t ɪ l s
timan	t ɪ m a n
timr	t ɪ m r̥
timreins	t ɪ m r i n s
timrja	t ɪ m r j a
timrjan	t ɪ m r j a n
timrjō	t ɪ m r j o
tiuhan	t ɪ u h a n
tiuhi	t ɪ u h ɪ
tōjis	t o j ɪ s
tōl	t o l
tráuains	t r ɔ ɛ n s
tráuan	t r ɔ a n
trausti	t r ɔ s t ɪ
trausts	t r ɔ s t s
trigan	t r ɪ ɣ a n
triggwa	t r ɪ ɡ ɡ w a
triggwaba	t r ɪ ɡ ɡ w a β a
triggws	t r ɪ ɡ ɡ w s
trigō	t r ɪ ɣ o
trimpan	t r ɪ m p a n
triniungeldo	t r ɪ n ɪ u n ɡ e l d o
trippōn	t r ɪ pː o n
triu	t r ɪ u
triweins	t r ɪ w i n s
trudan	t r u ð a n
trusnjan	t r u s n j a n
tufa	t u ɸ a
tuga	t u ɣ a
tuggl	t u ŋ ɡ l̥
tuggō	t u ŋ ɡ o
tuld	t u l d
tulgiþa	t u l ɡ ɪ θ a
tulgjan	t u l ɡ j a n
tulgus	t u l ɡ u s
tūn	t u n
tundi	t u n d ɪ
tundnan	t u n d n a n
tunþus	t u n θ u s
tuz	t u z
tuzwērjan	t u z w e r j a n
tuzwērs	t u z w e r s
twai	t w ɛ
twaitigjus	t w ɛ t ɪ ɣ j u s
twalibwintrus	t w a l ɪ β w ɪ n t r u s
twalif	t w a l ɪ ɸ
tweifleins	t w i ɸ l i n s
tweifljan	t w i ɸ l j a n
tweifls	t w i ɸ l̥ s
tweihnai	t w i h n ɛ
twis	t w ɪ s
twisstandan	t w ɪ sː t a n d a n
twisstass	t w ɪ sː t a sː
tyz	t j z
þadei	θ a ð i
þagkjan	θ a ŋ k j a n
þagks	θ a ŋ k s
þahains	θ a h ɛ n s
þahan	θ a h a n
þāhō	θ a h o
þahsus	θ a h s u s
þaírh	θ ɛ r h
þaírharbaidjan	θ ɛ r h a r b ɛ ð j a n
þaírhbaíran	θ ɛ r h b ɛ r a n
þaírhgaggan	θ ɛ r h ɡ a ŋ ɡ a n
þaírhgaleikōn	θ ɛ r h ɡ a l i k o n
þaírhleiþan	θ ɛ r h l i θ a n
þaírhsaíƕan	θ ɛ r h s ɛ ʍ a n
þaírhwakan	θ ɛ r h w a k a n
þaírhwisan	θ ɛ r h w ɪ s a n
þaírkō	θ ɛ r k o
þaírsan	θ ɛ r s a n
þakjan	θ a k j a n
þan	θ a n
þana	θ a n a
þanamais	θ a n a m ɛ s
þanaseiþs	θ a n a s i θ s
þandē	θ a n d e
þanei	θ a n i
þanjan	θ a n j a n
þannu	θ a nː u
þanuh	θ a n u h
þar	θ a r
þarba	θ a r b a
þarban	θ a r b a n
þarbs	θ a r b s
þarei	θ a r i
þarihs	θ a r ɪ h s
þaruh	θ a r u h
þatain	θ a t ɛ n
þatainei	θ a t ɛ n i
þatei	θ a t i
þaþrō	θ a θ r o
þaþrōei	θ a θ r o i
þaþrōh	θ a θ r o h
þau	θ ɔ
þauh	θ ɔ h
þauhjabai	θ ɔ h j a β ɛ
þaúr	θ ɔ r
þaúrban	θ ɔ r b a n
þaúrbs	θ ɔ r b s
þaúrfts	θ ɔ r ɸ t s
þaúris	θ ɔ r ɪ s
þaúrneins	θ ɔ r n i n s
þaúrnja	θ ɔ r n j a
þaúrnus	θ ɔ r n u s
þaúrp	θ ɔ r p
þaúrpan	θ ɔ r p a n
þaúrsiþs	θ ɔ r s ɪ θ s
þaúrsjan	θ ɔ r s j a n
þaursnan	θ ɔ r s n a n
þaúrstei	θ ɔ r s t i
þaúrsts	θ ɔ r s t s
þaúrsus	θ ɔ r s u s
þē	θ e
þēei	θ e i
þei	θ i
þeihan	θ i h a n
þeihs	θ i h s
þeihwō	θ i h w o
þeins	θ i n s
þēwis	θ e w ɪ s
þiljō	θ ɪ l j o
þinsan	θ ɪ n s a n
þiqjan	θ ɪ kʷ j a n
þishun	θ ɪ s h u n
þisƕaduh	θ ɪ s ʍ a ð u h
þisƕaruh	θ ɪ s ʍ a r u h
þisƕazuh	θ ɪ s ʍ a z u h
þiubi	θ ɪ u β ɪ
þiubjis	θ ɪ u β j ɪ s
þiubjō	θ ɪ u β j o
þiuda	θ ɪ u ð a
þiudangardi	θ ɪ u ð a n ɡ a r d ɪ
þiudanōn	θ ɪ u ð a n o n
þiudans	θ ɪ u ð a n s
þiudinassus	θ ɪ u ð ɪ n a sː u s
þiudiskō	θ ɪ u ð ɪ s k o
þiufaþia	θ ɪ u ɸ a θ ɪ a
þiufaþs	θ ɪ u ɸ a θ s
þiufaþus	θ ɪ u ɸ a θ u s
þiufs	θ ɪ u ɸ s
þiuh	θ ɪ u h
þiuhbrōks	θ ɪ u h b r o k s
þiumagus	θ ɪ u m a ɣ u s
þius	θ ɪ u s
þiuþ	θ ɪ u θ
þiuþan	θ ɪ u θ a n
þiuþei	θ ɪ u θ i
þiuþeigs	θ ɪ u θ i ɣ s
þiuþeins	θ ɪ u θ i n s
þiuþiqiss	θ ɪ u θ ɪ kʷ ɪ sː
þiuþjan	θ ɪ u θ j a n
þiuþs	θ ɪ u θ s
þiuþspillōn	θ ɪ u θ s p ɪ lː o n
þiwadw	θ ɪ w a ð w
þiwairna	θ ɪ w ɛ r n a
þiwan	θ ɪ w a n
þiwi	θ ɪ w ɪ
þlahsjan	θ l a h s j a n
þlahsnan	θ l a h s n a n
þlaihan	θ l ɛ h a n
þlaihts	θ l ɛ h t s
þlaqus	θ l a kʷ u s
þlaúhs	θ l ɔ h s
þliuhan	θ l ɪ u h a n
þrafsteins	θ r a ɸ s t i n s
þrafstjan	θ r a ɸ s t j a n
þrafsts	θ r a ɸ s t s
þragjan	θ r a ɣ j a n
þraihn	θ r ɛ h n̥
þramstei	θ r a m s t i
þras	θ r a s
þrasabalþei	θ r a s a β a l θ i
þrasabalþs	θ r a s a β a l θ s
þreihan	θ r i h a n
þreihsl	θ r i h s l̥
þreis	θ r i s
þreistigjus	θ r i s t ɪ ɣ j u s
þridja	θ r ɪ ð j a
þridjataihun	θ r ɪ ð j a t ɛ h u n
þridjō	θ r ɪ ð j o
þrimman	θ r ɪ mː a n
þriskan	θ r ɪ s k a n
þriutan	θ r ɪ u t a n
þrōþjan	θ r o θ j a n
þruks	θ r u k s
þrūtsfill	θ r u t s ɸ ɪ lː
þrūtsfills	θ r u t s ɸ ɪ lː s
þrūþs	θ r u θ s
þū	θ u
þūei	θ u i
þufaz	θ u ɸ a z
þugkjan	θ u ŋ k j a n
þūhts	θ u h t s
þūhtus	θ u h t u s
þulains	θ u l ɛ n s
þulan	θ u l a n
þulds	θ u l d s
þunara	θ u n a r a
þund	θ u n d
þunds	θ u n d s
þūs	θ u s
þūsundi	θ u s u n d ɪ
þūsundifaþs	θ u s u n d ɪ ɸ a θ s
þuthaúrn	θ u t h ɔ r n̥
þuthaúrnjan	θ u t h ɔ r n j a n
þuts	θ u t s
þwahan	θ w a h a n
þwahl	θ w a h l̥
þwaírhei	θ w ɛ r h i
þwaírhs	θ w ɛ r h s
þwastiþa	θ w a s t ɪ θ a
þwastjan	θ w a s t j a n
þwasts	θ w a s t s
þwmiama	θ w m ɪ a m a
u	u
ubil	u β ɪ l
ubilaba	u β ɪ l a β a
ubils	u β ɪ l s
ubiltōjis	u β ɪ l t o j ɪ s
ubilwaúrdjan	u β ɪ l w ɔ r d j a n
ubilwaúrds	u β ɪ l w ɔ r d s
ubizwa	u β ɪ z w a
ubuh	u β u h
uf	u ɸ
ufaiþeis	u ɸ ɛ θ i s
ufanus	u ɸ a n u s
ufar	u ɸ a r
ufara	u ɸ a r a
ufarassjan	u ɸ a r a sː j a n
ufarassus	u ɸ a r a sː u s
ufarfullei	u ɸ a r ɸ u lː i
ufarfulljan	u ɸ a r ɸ u lː j a n
ufarfulls	u ɸ a r ɸ u lː s
ufargaggan	u ɸ a r ɡ a ŋ ɡ a n
ufargiutan	u ɸ a r ɡ ɪ u t a n
ufargudja	u ɸ a r ɡ u ð j a
ufarhafjan	u ɸ a r h a ɸ j a n
ufarhafnan	u ɸ a r h a ɸ n a n
ufarhamōn	u ɸ a r h a m o n
ufarhauhjan	u ɸ a r h ɔ h j a n
ufarhauseins	u ɸ a r h ɔ s i n s
ufarhausjan	u ɸ a r h ɔ s j a n
ufarhiminakunds	u ɸ a r h ɪ m ɪ n a k u n d s
ufarhleiþrjan	u ɸ a r h l i θ r j a n
ufarhugjan	u ɸ a r h u ɣ j a n
ufarjaina	u ɸ a r j ɛ n a
ufarlagjan	u ɸ a r l a ɣ j a n
ufarleiþan	u ɸ a r l i θ a n
ufarmaudei	u ɸ a r m ɔ ð i
ufarmaudjan	u ɸ a r m ɔ ð j a n
ufarmēleins	u ɸ a r m e l i n s
ufarmēli	u ɸ a r m e l ɪ
ufarmēljan	u ɸ a r m e l j a n
ufarmitōn	u ɸ a r m ɪ t o n
ufarmunnōn	u ɸ a r m u nː o n
ufarō	u ɸ a r o
ufarranneins	u ɸ a rː a nː i n s
ufarrannjan	u ɸ a rː a nː j a n
ufarskadwjan	u ɸ a r s k a ð w j a n
ufarskafts	u ɸ a r s k a ɸ t s
ufarsteigan	u ɸ a r s t i ɣ a n
ufarswara	u ɸ a r s w a r a
ufarswaran	u ɸ a r s w a r a n
ufartrusnjan	u ɸ a r t r u s n j a n
ufarþeihan	u ɸ a r θ i h a n
ufarwahsjan	u ɸ a r w a h s j a n
ufarwisan	u ɸ a r w ɪ s a n
ufbauljan	u ɸ b ɔ l j a n
ufblēsan	u ɸ b l e s a n
ufbrikan	u ɸ b r ɪ k a n
ufbrinnan	u ɸ b r ɪ nː a n
ufdaupjan	u ɸ d ɔ p j a n
ufgaírdan	u ɸ ɡ ɛ r d a n
ufgraban	u ɸ ɡ r a β a n
ufhaban	u ɸ h a β a n
ufhauseins	u ɸ h ɔ s i n s
ufhausjan	u ɸ h ɔ s j a n
ufhlōhjan	u ɸ h l o h j a n
ufhnaiweins	u ɸ h n ɛ w i n s
ufhnaiwjan	u ɸ h n ɛ w j a n
ufhrōpjan	u ɸ h r o p j a n
ufjō	u ɸ j o
ufkunnan	u ɸ k u nː a n
ufkunþi	u ɸ k u n θ ɪ
ufligan	u ɸ l ɪ ɣ a n
ufmēljan	u ɸ m e l j a n
ufrakjan	u ɸ r a k j a n
ufsaggqjan	u ɸ s a ŋ ɡ kʷ j a n
ufsliupan	u ɸ s l ɪ u p a n
ufsneiþan	u ɸ s n i θ a n
ufstraujan	u ɸ s t r ɔ j a n
ufswalleins	u ɸ s w a lː i n s
ufswalljan	u ɸ s w a lː j a n
ufswōgjan	u ɸ s w o ɣ j a n
ufta	u ɸ t a
uftō	u ɸ t o
ufþanjan	u ɸ θ a n j a n
ufwaíra	u ɸ w ɛ r a
ufwōpjan	u ɸ w o p j a n
ugkar	u ŋ k a r
ugkja	u ŋ k j a
uh	u h
ūhteigō	u h t i ɣ o
ūhteigs	u h t i ɣ s
ūhti	u h t ɪ
ūhtiugs	u h t ɪ u ɣ s
ūhtwō	u h t w o
ulbandus	u l b a n d u s
un	u n
unagands	u n a ɣ a n d s
unagei	u n a ɣ i
unags	u n a ɣ s
unaírkns	u n ɛ r k n̥ s
unaiwisks	u n ɛ w ɪ s k s
unanasiuniba	u n a n a s ɪ u n ɪ β a
unanasiuns	u n a n a s ɪ u n s
unandhuliþs	u n a n d h u l ɪ θ s
unandsakans	u n a n d s a k a n s
unandsōks	u n a n d s o k s
unatgāhts	u n a t ɡ a h t s
unbaírands	u n b ɛ r a n d s
unbarnahs	u n b a r n a h s
unbaúrans	u n b ɔ r a n s
unbeistei	u n b i s t i
unbeistjōþs	u n b i s t j o θ s
unbiari	u n b ɪ a r ɪ
unbilaistiþs	u n b ɪ l ɛ s t ɪ θ s
unbimait	u n b ɪ m ɛ t
unbimaitans	u n b ɪ m ɛ t a n s
unbrūks	u n b r u k s
und	u n d
undar	u n d a r
undarists	u n d a r ɪ s t s
undarleija	u n d a r l i j a
undarleis	u n d a r l i s
undarō	u n d a r o
undaúrnimats	u n d ɔ r n ɪ m a t s
undgreipan	u n d ɡ r i p a n
undiwanei	u n d ɪ w a n i
undiwans	u n d ɪ w a n s
undrēdan	u n d r e ð a n
undrinnan	u n d r ɪ nː a n
unfagrs	u n ɸ a ɣ r̥ s
unfaírina	u n ɸ ɛ r ɪ n a
unfaírinōdaba	u n ɸ ɛ r ɪ n o ð a β a
unfaírlaistiþs	u n ɸ ɛ r l ɛ s t ɪ θ s
unfaurs	u n ɸ ɔ r s
unfaúrweis	u n ɸ ɔ r w i s
unfraþjands	u n ɸ r a θ j a n d s
unfreideins	u n ɸ r i ð i n s
unfrōdei	u n ɸ r o ð i
unfrōþs	u n ɸ r o θ s
ungafaírinōnds	u n ɡ a ɸ ɛ r ɪ n o n d s
ungafaírinōþs	u n ɡ a ɸ ɛ r ɪ n o θ s
ungahabandssik	u n ɡ a h a β a n d sː ɪ k
ungahōbains	u n ɡ a h o β ɛ n s
ungaƕaírbs	u n ɡ a ʍ ɛ r b s
ungakusans	u n ɡ a k u s a n s
ungalaubeins	u n ɡ a l ɔ β i n s
ungalaubjands	u n ɡ a l ɔ β j a n d s
ungalaufs	u n ɡ a l ɔ ɸ s
ungaraíhtei	u n ɡ a r ɛ h t i
ungasaíƕans	u n ɡ a s ɛ ʍ a n s
ungastōþs	u n ɡ a s t o θ s
ungatass	u n ɡ a t a sː
ungatassaba	u n ɡ a t a sː a β a
ungatēwiþs	u n ɡ a t e w ɪ θ s
ungawagiþs	u n ɡ a w a ɣ ɪ θ s
unhabands	u n h a β a n d s
unhaili	u n h ɛ l ɪ
unhails	u n h ɛ l s
unhanduwaúrhts	u n h a n d u w ɔ r h t s
unhindarweis	u n h ɪ n d a r w i s
unhrainei	u n h r ɛ n i
unhrainiþa	u n h r ɛ n ɪ θ a
unhrains	u n h r ɛ n s
unhulþa	u n h u l θ a
unhulþō	u n h u l θ o
unhunslags	u n h u n s l a ɣ s
unƕapnands	u n ʍ a p n a n d s
unƕeila	u n ʍ i l a
unkarja	u n k a r j a
unkaúreins	u n k ɔ r i n s
unkunnands	u n k u nː a n d s
unkunþi	u n k u n θ ɪ
unkunþs	u n k u n θ s
unlēdi	u n l e ð ɪ
unlēdjan	u n l e ð j a n
unlēþs	u n l e θ s
unliufs	u n l ɪ u ɸ s
unliugaiþs	u n l ɪ u ɣ ɛ θ s
unliugands	u n l ɪ u ɣ a n d s
unliuts	u n l ɪ u t s
unlustus	u n l u s t u s
unmahteigs	u n m a h t i ɣ s
unmahts	u n m a h t s
unmanariggws	u n m a n a r ɪ ɡ ɡ w s
unmanwus	u n m a n w u s
unmilds	u n m ɪ l d s
unnuts	u nː u t s
unqēniþs	u n kʷ e n ɪ θ s
unqēþs	u n kʷ e θ s
unriurei	u n r ɪ u r i
unriureis	u n r ɪ u r i s
unrōdjands	u n r o ð j a n d s
unsahtaba	u n s a h t a β a
unsaíƕands	u n s ɛ ʍ a n d s
unsaltans	u n s a l t a n s
unsar	u n s a r
unsēlei	u n s e l i
unsēls	u n s e l s
unsibjis	u n s ɪ β j ɪ s
unskaus	u n s k ɔ s
unsūti	u n s u t ɪ
unsweibands	u n s w i β a n d s
unswēran	u n s w e r a n
unswērei	u n s w e r i
unswēriþa	u n s w e r ɪ θ a
unswērs	u n s w e r s
unswikunþs	u n s w ɪ k u n θ s
untals	u n t a l s
untē	u n t e
untilamalsks	u n t ɪ l a m a l s k s
untriggws	u n t r ɪ ɡ ɡ w s
unþaþlíuhan	u n θ a θ l i u h a n
unþiuda	u n θ ɪ u ð a
unþiuþ	u n θ ɪ u θ
unþiuþjan	u n θ ɪ u θ j a n
unþwahans	u n θ w a h a n s
unufbrikands	u n u ɸ b r ɪ k a n d s
unūhteigō	u n u h t i ɣ o
unūhteigs	u n u h t i ɣ s
unuslaisiþs	u n u s l ɛ s ɪ θ s
unusspillōþs	u n u sː p ɪ lː o θ s
unwāhs	u n w a h s
unwaírþaba	u n w ɛ r θ a β a
unwaírþs	u n w ɛ r θ s
unwammei	u n w a mː i
unwamms	u n w a mː s
unwaúrstwō	u n w ɔ r s t w o
unweis	u n w i s
unwēniggō	u n w e n ɪ ŋ ɡ o
unwērei	u n w e r i
unwērjan	u n w e r j a n
unwērs	u n w e r s
unwiss	u n w ɪ sː
unwita	u n w ɪ t a
unwitands	u n w ɪ t a n d s
unwiti	u n w ɪ t ɪ
unwunands	u n w u n a n d s
ur	u r
urraisjan	u rː ɛ s j a n
urrannjan	u rː a nː j a n
urrēdan	u rː e ð a n
urreisan	u rː i s a n
urrinnan	u rː ɪ nː a n
urrists	u rː ɪ s t s
urrugks	u rː u ŋ k s
urrūmnan	u rː u m n a n
urruns	u rː u n s
ūrs	u r s
us	u s
usagjan	u s a ɣ j a n
usagljan	u s a ɣ l j a n
usaiwjan	u s ɛ w j a n
usalþan	u s a l θ a n
usbaíran	u s b ɛ r a n
usbalþei	u s b a l θ i
usbalþjan	u s b a l θ j a n
usbaugjan	u s b ɔ ɣ j a n
usbeidan	u s b i ð a n
usbeisnei	u s b i s n i
usbeisneigs	u s b i s n i ɣ s
usbeisns	u s b i s n̥ s
usbidan	u s b ɪ ð a n
usbliggwan	u s b l ɪ ɡ ɡ w a n
usblōtan	u s b l o t a n
usblōteins	u s b l o t i n s
usbraidjan	u s b r ɛ ð j a n
usbruknan	u s b r u k n a n
usbugjan	u s b u ɣ j a n
usdaudei	u s d ɔ ð i
usdaudjan	u s d ɔ ð j a n
usdaudō	u s d ɔ ð o
usdauþs	u s d ɔ θ s
usdreiban	u s d r i β a n
usdriusan	u s d r ɪ u s a n
usdrusts	u s d r u s t s
usfaírina	u s ɸ ɛ r ɪ n a
usfarþō	u s ɸ a r θ o
usfarþōn	u s ɸ a r θ o n
usfilh	u s ɸ ɪ l h
usfilhan	u s ɸ ɪ l h a n
usfilma	u s ɸ ɪ l m a
usfilmei	u s ɸ ɪ l m i
usfōdeins	u s ɸ o ð i n s
usfōdjan	u s ɸ o ð j a n
usfraisan	u s ɸ r ɛ s a n
usfratwjan	u s ɸ r a t w j a n
usfulleins	u s ɸ u lː i n s
usfulljan	u s ɸ u lː j a n
usfullnan	u s ɸ u lː n a n
usgaggan	u s ɡ a ŋ ɡ a n
usgaisjan	u s ɡ ɛ s j a n
usgeisnan	u s ɡ i s n a n
usgiban	u s ɡ ɪ β a n
usgildan	u s ɡ ɪ l d a n
usgraban	u s ɡ r a β a n
usgrudja	u s ɡ r u ð j a
usgutnan	u s ɡ u t n a n
ushafjan	u s h a ɸ j a n
ushāhansik	u s h a h a n s ɪ k
ushaista	u s h ɛ s t a
ushaitan	u s h ɛ t a n
ushauhjan	u s h ɔ h j a n
ushauhnan	u s h ɔ h n a n
ushinþan	u s h ɪ n θ a n
ushlaupan	u s h l ɔ p a n
ushrainjan	u s h r ɛ n j a n
ushramjan	u s h r a m j a n
ushrisjan	u s h r ɪ s j a n
ushulōn	u s h u l o n
uskannjan	u s k a nː j a n
uskeinan	u s k i n a n
uskiusan	u s k ɪ u s a n
uskunþs	u s k u n θ s
uslagjan	u s l a ɣ j a n
uslaisiþs	u s l ɛ s ɪ θ s
uslaisjan	u s l ɛ s j a n
uslaubjan	u s l ɔ β j a n
uslauseins	u s l ɔ s i n s
uslausjan	u s l ɔ s j a n
usleiþan	u s l i θ a n
uslētan	u s l e t a n
usliþa	u s l ɪ θ a
usluk	u s l u k
uslūkan	u s l u k a n
uslūknan	u s l u k n a n
usluneins	u s l u n i n s
uslunjan	u s l u n j a n
uslutōn	u s l u t o n
usmaitan	u s m ɛ t a n
usmanagnan	u s m a n a ɣ n a n
usmērjan	u s m e r j a n
usmērnan	u s m e r n a n
usmēt	u s m e t
usmitan	u s m ɪ t a n
usniman	u s n ɪ m a n
usqiman	u s kʷ ɪ m a n
usqiss	u s kʷ ɪ sː
usqistjan	u s kʷ ɪ s t j a n
usqiþan	u s kʷ ɪ θ a n
usrūmnan	u s r u m n a n
ussaíƕan	u sː ɛ ʍ a n
ussakan	u sː a k a n
ussaljan	u sː a l j a n
ussandjan	u sː a n d j a n
ussateins	u sː a t i n s
ussatjan	u sː a t j a n
ussiggwan	u sː ɪ ɡ ɡ w a n
ussindō	u sː ɪ n d o
ussinþs	u sː ɪ n θ s
ussitan	u sː ɪ t a n
usskarjan	u sː k a r j a n
ussōkjan	u sː o k j a n
usspillōn	u sː p ɪ lː o n
usspillōþs	u sː p ɪ lː o θ s
usstaggan	u sː t a ŋ ɡ a n
usstandan	u sː t a n d a n
usstass	u sː t a sː
ussteigan	u sː t i ɣ a n
usstiurei	u sː t ɪ u r i
usstiuriba	u sː t ɪ u r ɪ β a
usstiurs	u sː t ɪ u r s
ustaikneins	u s t ɛ k n i n s
ustaiknjan	u s t ɛ k n j a n
ustaúhts	u s t ɔ h t s
ustiuhan	u s t ɪ u h a n
usþinsan	u s θ ɪ n s a n
usþriutan	u s θ r ɪ u t a n
usþrōþeins	u s θ r o θ i n s
usþrōþjan	u s θ r o θ j a n
usþulains	u s θ u l ɛ n s
usþulan	u s θ u l a n
usþwahan	u s θ w a h a n
uswagjan	u s w a ɣ j a n
uswahsans	u s w a h s a n s
uswahsjan	u s w a h s j a n
uswahsts	u s w a h s t s
uswaírpan	u s w ɛ r p a n
uswakjan	u s w a k j a n
uswalteins	u s w a l t i n s
uswaltjan	u s w a l t j a n
uswalugjan	u s w a l u ɣ j a n
uswandeins	u s w a n d i n s
uswandi	u s w a n d ɪ
uswandjan	u s w a n d j a n
uswaúrhts	u s w ɔ r h t s
uswaúrkjan	u s w ɔ r k j a n
uswaúrpa	u s w ɔ r p a
usweihs	u s w i h s
uswēna	u s w e n a
uswindan	u s w ɪ n d a n
uswiss	u s w ɪ sː
uswissi	u s w ɪ sː ɪ
ūt	u t
ūta	u t a
ūtana	u t a n a
ūtaþrō	u t a θ r o
ūtbaíran	u t b ɛ r a n
ūtgaggan	u t ɡ a ŋ ɡ a n
uzanan	u z a n a n
uzds	u z d s
uzēta	u z e t a
wad	w a ð
waddjus	w a dː j u s
wadi	w a ð ɪ
wadjabōkōs	w a ð j a β o k o s
wadjōn	w a ð j o n
wagga	w a ŋ ɡ a
waggāreis	w a ŋ ɡ a r i s
waggō	w a ŋ ɡ o
waggs	w a ŋ ɡ s
waghen	w a ɣ h e n
wagjan	w a ɣ j a n
wāhs	w a h s
wahsjan	w a h s j a n
wahsts	w a h s t s
wahstus	w a h s t u s
wahtwō	w a h t w o
wai	w ɛ
wáian	w ɛ a n
waibjan	w ɛ β j a n
waida	w ɛ ð a
waidēdja	w ɛ ð e ð j a
waidēþs	w ɛ ð e θ s
waifaírƕjan	w ɛ ɸ ɛ r ʍ j a n
waihjō	w ɛ h j o
waíhsta	w ɛ h s t a
waíhstastains	w ɛ h s t a s t ɛ n s
waíht	w ɛ h t
waíhts	w ɛ h t s
waíla	w ɛ l a
waíladēþs	w ɛ l a ð e θ s
waílamērei	w ɛ l a m e r i
waílamēreins	w ɛ l a m e r i n s
waílamēreis	w ɛ l a m e r i s
waílamērjan	w ɛ l a m e r j a n
waílaqiss	w ɛ l a kʷ ɪ sː
waílaspillōn	w ɛ l a s p ɪ lː o n
waílawizns	w ɛ l a w ɪ z n̥ s
wainahs	w ɛ n a h s
wainei	w ɛ n i
wainjan	w ɛ n j a n
wainōn	w ɛ n o n
waipjan	w ɛ p j a n
waips	w ɛ p s
waír	w ɛ r
waíraleikō	w ɛ r a l i k o
waíraleiks	w ɛ r a l i k s
waírdus	w ɛ r d u s
waírilō	w ɛ r ɪ l o
waírpan	w ɛ r p a n
waírs	w ɛ r s
waírsiza	w ɛ r s ɪ z a
waírþ	w ɛ r θ
waírþaba	w ɛ r θ a β a
waírþan	w ɛ r θ a n
waírþeigs	w ɛ r θ i ɣ s
waírþi	w ɛ r θ ɪ
waírþida	w ɛ r θ ɪ ð a
waírþis	w ɛ r θ ɪ s
waírþja	w ɛ r θ j a
waírþjan	w ɛ r θ j a n
waírþnan	w ɛ r θ n a n
waírþōn	w ɛ r θ o n
waírþs	w ɛ r θ s
waitei	w ɛ t i
waiþja	w ɛ θ j a
wajamērei	w a j a m e r i
wajamēreins	w a j a m e r i n s
wajamēreis	w a j a m e r i s
wajamērjan	w a j a m e r j a n
wakan	w a k a n
wakjan	w a k j a n
waknan	w a k n a n
wakrs	w a k r̥ s
wala	w a l a
walda	w a l d a
waldan	w a l d a n
waldands	w a l d a n d s
walds	w a l d s
waldufni	w a l d u ɸ n ɪ
waldus	w a l d u s
waleins	w a l i n s
walgjan	w a l ɡ j a n
walhs	w a l h s
walisa	w a l ɪ s a
waljan	w a l j a n
walteins	w a l t i n s
waltjan	w a l t j a n
walugjan	w a l u ɣ j a n
walus	w a l u s
walwisōn	w a l w ɪ s o n
walwjan	w a l w j a n
wamba	w a m b a
wamm	w a mː
wammei	w a mː i
wammjan	w a mː j a n
wamms	w a mː s
wan	w a n
wanains	w a n ɛ n s
wanan	w a n a n
Wandals	w a n d a l s
wandeins	w a n d i n s
wandi	w a n d ɪ
wandjan	w a n d j a n
wandus	w a n d u s
waninassus	w a n ɪ n a sː u s
wans	w a n s
warda	w a r d a
wardeins	w a r d i n s
wardja	w a r d j a
wardō	w a r d o
wardōn	w a r d o n
wards	w a r d s
warei	w a r i
wargeins	w a r ɡ i n s
wargiþa	w a r ɡ ɪ θ a
wargjan	w a r ɡ j a n
wargs	w a r ɡ s
warjan	w a r j a n
warmjan	w a r m j a n
warms	w a r m̥ s
warnjan	w a r n j a n
warōn	w a r o n
wars	w a r s
waseins	w a s i n s
wasjan	w a s j a n
wasti	w a s t ɪ
watō	w a t o
waúrd	w ɔ r d
waúrdahs	w ɔ r d a h s
waúrdajiuka	w ɔ r d a j ɪ u k a
waúrdei	w ɔ r d i
waúrdi	w ɔ r d ɪ
waúrhts	w ɔ r h t s
waúrk	w ɔ r k
waúrki	w ɔ r k ɪ
waúrkjan	w ɔ r k j a n
waúrms	w ɔ r m̥ s
waúrstw	w ɔ r s t w
waúrstwa	w ɔ r s t w a
waúrstwei	w ɔ r s t w i
waúrstweigs	w ɔ r s t w i ɣ s
waúrstwja	w ɔ r s t w j a
waúrstws	w ɔ r s t w s
waúrts	w ɔ r t s
wēgs	w e ɣ s
weida	w i ð a
weidōn	w i ð o n
weif	w i ɸ
weigs	w i ɣ s
weih	w i h
weiha	w i h a
weihaba	w i h a β a
weihan	w i h a n
weihiþa	w i h ɪ θ a
weihnan	w i h n a n
weihs	w i h s
wein	w i n
weinabasi	w i n a β a s ɪ
weinagards	w i n a ɣ a r d s
weinags	w i n a ɣ s
weinatains	w i n a t ɛ n s
weinatriu	w i n a t r ɪ u
weindrugkja	w i n d r u ŋ k j a
weipan	w i p a n
weis	w i s
weisa	w i s a
weisei	w i s i
weisjan	w i s j a n
weisōn	w i s o n
weitan	w i t a n
weiti	w i t ɪ
weitjan	w i t j a n
weitwōdei	w i t w o ð i
weitwōdeins	w i t w o ð i n s
weitwōdi	w i t w o ð ɪ
weitwōdiþa	w i t w o ð ɪ θ a
weitwōdjan	w i t w o ð j a n
weitwōþs	w i t w o θ s
wēniggō	w e n ɪ ŋ ɡ o
wēnjan	w e n j a n
wēns	w e n s
wēpn	w e p n̥
wēreis	w e r i s
wērjan	w e r j a n
wērjands	w e r j a n d s
wēsei	w e s i
wida	w ɪ ð a
wīda	w i ð a
widan	w ɪ ð a n
wīds	w i ð s
widus	w ɪ ð u s
widuwaírna	w ɪ ð u w ɛ r n a
widuwō	w ɪ ð u w o
wigadeinō	w ɪ ɣ a ð i n o
wigan	w ɪ ɣ a n
wigis	w ɪ ɣ ɪ s
wigs	w ɪ ɣ s
wīhjan	w i h j a n
wikō	w ɪ k o
wilja	w ɪ l j a
wiljahalþei	w ɪ l j a h a l θ i
wiljahalþs	w ɪ l j a h a l θ s
wiljan	w ɪ l j a n
wiljei	w ɪ l j i
wiltan	w ɪ l t a n
wilþeis	w ɪ l θ i s
wilwa	w ɪ l w a
wilwan	w ɪ l w a n
windags	w ɪ n d a ɣ s
windan	w ɪ n d a n
windiþa	w ɪ n d ɪ θ a
winds	w ɪ n d s
Winiþs	w ɪ n ɪ θ s
winja	w ɪ n j a
winna	w ɪ nː a
winnan	w ɪ nː a n
winne	w ɪ nː e
winnō	w ɪ nː o
wins	w ɪ n s
wintrus	w ɪ n t r u s
winþeis	w ɪ n θ i s
winþiskaúrō	w ɪ n θ ɪ s k ɔ r o
winþjan	w ɪ n θ j a n
wipja	w ɪ p j a
wis	w ɪ s
wīs	w i s
wisan	w ɪ s a n
Wisands	w ɪ s a n d s
Wisigoti	w ɪ s ɪ ɣ o t ɪ
wiss	w ɪ sː
wissei	w ɪ sː i
wissi	w ɪ sː ɪ
wist	w ɪ s t
wista	w ɪ s t a
wistr	w ɪ s t r̥
wistra	w ɪ s t r a
wists	w ɪ s t s
wisus	w ɪ s u s
wit	w ɪ t
wita	w ɪ t a
witains	w ɪ t ɛ n s
witan	w ɪ t a n
witands	w ɪ t a n d s
witi	w ɪ t ɪ
witōdafasteis	w ɪ t o ð a ɸ a s t i s
witōdafasts	w ɪ t o ð a ɸ a s t s
witōdalaisāreis	w ɪ t o ð a l ɛ s a r i s
witōdalaus	w ɪ t o ð a l ɔ s
witōdeigō	w ɪ t o ð i ɣ o
witōþ	w ɪ t o θ
witōþs	w ɪ t o θ s
wits	w ɪ t s
witubni	w ɪ t u β n ɪ
wituls	w ɪ t u l s
wiþōn	w ɪ θ o n
wiþra	w ɪ θ r a
wiþragaggan	w ɪ θ r a ɣ a ŋ ɡ a n
wiþragamōtjan	w ɪ θ r a ɣ a m o t j a n
wiþrawaírþs	w ɪ θ r a w ɛ r θ s
wiþrus	w ɪ θ r u s
wizdila	w ɪ z d ɪ l a
wizdils	w ɪ z d ɪ l s
wizneigs	w ɪ z n i ɣ s
wizns	w ɪ z n̥ s
wizōn	w ɪ z o n
wlaitōn	w l ɛ t o n
wleitan	w l i t a n
wleizn	w l i z n̥
wliti	w l ɪ t ɪ
wlits	w l ɪ t s
wlizjan	w l ɪ z j a n
wōkains	w o k ɛ n s
wōkan	w o k a n
wōkrs	w o k r̥ s
wōpjan	w o p j a n
wōþeis	w o θ i s
wōþs	w o θ s
wraiqs	w r ɛ kʷ s
wraka	w r a k a
wrakja	w r a k j a
wrakjan	w r a k j a n
wraks	w r a k s
wranks	w r a n k s
wratōdus	w r a t o ð u s
wratōn	w r a t o n
wreitan	w r i t a n
wrēkei	w r e k i
wrēks	w r e k s
wrēþus	w r e θ u s
wriggan	w r ɪ ŋ ɡ a n
wrikan	w r ɪ k a n
wrisqan	w r ɪ s kʷ a n
writs	w r ɪ t s
wrōhjan	w r o h j a n
wrōhs	w r o h s
wrōtjan	w r o t j a n
wruggō	w r u ŋ ɡ o
wulan	w u l a n
wulfs	w u l ɸ s
wulla	w u lː a
wullāreis	w u lː a r i s
wulþags	w u l θ a ɣ s
wulþrs	w u l θ r̥ s
wulþus	w u l θ u s
wulwa	w u l w a
wunan	w u n a n
wunands	w u n a n d s
wundōn	w u n d o n
wunds	w u n d s
wundufni	w u n d u ɸ n ɪ
wunns	w u nː s
wunsk	w u n s k
Zēlōtēs	z e l o t e s
