Gothic	Meaning
a	a, Abkürzung für 1
aba	Ehemann, Gatte
abba	Vater
abraba	sehr
abrjan	stark werden
abrs	stark, heftig
ada	Ei
addi	Ei
adrs	schnell, rasch
ael	Stein
af	von, von weg, von her, seit, ab, zu, aus
afagjan	ängstigen, sich ängstigen, abschrecken
afaikan	leugnen, fluchen, verleugnen
afaírzjan	irre machen, abweichen
afar	nach, hinter, hernach, zufolge, an
afara	Nachkomme
afardags	der folgende Tag
afargaggan	nachgehen, folgen
afarlaistjan	nachfolgen, nachstreben, nachgehen, verfolgen
afarsabbate	Nachsabbat
afaruþþan	nach
afblindnan	erblinden
afdailjan	abteilen, einen Teil abgeben
afdaubnan	ertauben, verstockt werden, taub werden
afdáuiþs	geschunden, geplagt, abgehetzt
afdauþjan	töten
afdōbnan	verstummen
afdōjan	plagen, schinden, abhetzen
afdōmeins	Verdammung
afdōmjan	verurteilen, verfluchen
afdrausjan	hinabstürzen
afdrugk	Trinken
afdrugkja	Trunkenbold
afdumbnan	verstummen
afēt	Wegesserei, Fressen
afētja	Fresser
afēts	essbar, fresserisch
affilhan	verbergen
afgaggan	weggehen von, weggehen, weichen
afgibansik	sich wegbegeben, sich hinwegbegeben, sich fortbegeben
afgrundiþa	Abgrund
afgrundus	abgründig
afgudei	Gottlosigkeit
afguþs	abgöttisch, gottlos
afhabansik)	sich enthalten
afhaimeis	der Heimat fern, abwesend
afhamōn	die Bekleidung ablegen, ausziehen, sich entkleiden
afhlaþan	beladen
afhōlōn	übervorteilen, betrügen
afhrainjan	etwas Verunreinigendes tilgen, reinigen
afhrisjan	abschütteln
afhugjan	bezaubern
afƕapjan	ersticken, auslöschen
afƕapnan	ersticken, erlöschen
afitan	verschlingen, fressen
aflageins	Ablegung, Erlass, Vergebung
aflagjan	etwas ablegen
afleiþan	weggehen, entweichen, verreisen, fortgehen
aflēt	Erlass, Vergebung
aflētan	entlassen, vernachlässigen
aflifnan	übrigbleiben
aflinnan	weggehen, fortgehen
afmaitan	abhauen, abschneiden
afmarzeins	Betrug
afmarzjan	Ärgernis nehmen, sich ärgern
afmáuiþs	ermüdet
afmōjan	ermüden
afniman	wegnehmen, abnehmen
afqiþan	verzichten auf, entsagen
afsateins	Absetzung, Entlassung, Verabschiedung, Scheidung
afsatjan	absetzen, entlassen
afskaidan	abscheiden, absondern, abtrennen, trennen
afskiuban	verstoßen, von sich wegstoßen, abschieben, von sich schieben, entfernen
afslahan	abschlagen, abhauen, erschlagen
afslaupjan	abstreifen, ablegen
afslauþjan	in Angst versetzen, in Sorge sein, ängstigen
afslauþnan	erschrecken, sich entsetzen
afstandan	abstehen, ablassen, abfallen
afstass	Abfall, Scheidung
afswaggwjan	schwankend machen, ängstlich machen
afswaírban	abwischen, auslöschen
afta	hinten
aftana	von hinten
aftarō	von hinten, hinten
aftaúrnan	abreißen
aftiuhan	wegziehen, abziehen, fortziehen
aftra	wieder, zurück, rückwärts, wiederum, abermals
aftraanastōdeins	Wiederanfang, Wiedererneuerung
aftuma	letzte, hintere
aftumists	letzte
afþaúrsjan	dursten, verdursten, durstig sein
afþliuhan	wegfliehen, fliehen
afþwahan	sich abwaschen, waschen, sich waschen
afwagjan	bewegen, abbringen
afwaírpan	etwas wegwerfen, weichen, fortwerfen
afwalwjan	wegwälzen
afwandjan	abwenden, vermeiden
agan	sich fürchten
agands	furchtsam
agatja	Elster
agei	Furchtsamkeit, Ängstlichkeit
agga	Enge
Aggils	Angel
aggilus	Engel, Bote
aggwei	Enge, Einschränkung
aggwiþa	Enge, Bedrängnis
aggwjan	bedrängen, beengen, engen
aggwus	eng
agi	Schärfe, Ecke, Spitze, Schneide, Schwert
agis	Furcht, Schrecken
agjan	ängstigen, sich fürchten
agkja	Bein, Röhre
aglaitei	Unzucht, Unschicklichkeit, Unkeuschheit
aglaiteis	schändlich, unzüchtig
aglaitgastalds	schmutzig gewinnsüchtig, habsüchtig
aglaiti	Unzucht, Unschicklichkeit, Unkeuschheit
aglaitiwáurdei	Schandrede, unzüchtiges Reden
aglaitiwáurds	verleumderisch, schändlich
agliþa	Drangsal, Trübsal
agljan	schaden, belästigen
aglō	Drangsal
agls	schimpflich
agluba	schwer, schwerlich
aglus	schwierig
agra	scharf, spitz
ags	furchtsam, ängstlich
aha	Sinn, Verstand
ahaks	zahme weiße Taube, Taube
ahana	Spreu
ahjan	meinen
ahma	Geist
ahmateins	Eingebung, Inspiration
ahmatjan	eingeben
ahmeins	geistig, geistlich
ahs	Ähre
ahs	verständig, besonnen
ahsa	Achse, Achsel, aRune
ahtau	acht
ahtaudōgs	achttägig
ahtautaihun	achtzehn
ahtautēhund	achtzig
ahtuda	achte
aƕa	Fluss, Gewässer
aids	Feuer, Brand
aíffaþa	öffne dich
aifrs	schrecklich
aigan	haben
aigin	Eigentum, Vermögen
aiginōn	aneignen
aigins	eigen
aihtr	Klage, Bitte
aihtrōn	beten, betteln, erbitten, für sich verlangen
aihtrōns	Bitte, Gebet
aihts	Eigentum, Besitz, Habe, Gut
aíƕatundi	Pferdedorn, Dornstrauch
aíƕs	Pferd, eRune
aikan	sprechen
aíkklesjō	Kirche, Gotteshaus, Gemeinde
aiks	Eiche
aílōe	eloi, mein Gott
ainabaúr	eingeboren
ainaha	einzig
ainakls	vereinzelt, alleinstehend, einzeln
ainamundiþa	Einheit, Einmütigkeit
ainamunds	einmütig
ainfalþaba	einfältig
ainfalþei	Einfalt, Einfachheit
ainfalþs	einfach, einfältig
ainƕarjizuh	ein jeder
ainƕaþaruh	jeder von beiden
ainlif	elf
ains	ein, alleinig, ein einziger, ein gewisser, irgendein, einmal
ainshun	irgendein, jeder, niemand
aípiskaúpei	Bischofsamt
aípiskaúpus	Bischof
aípistaúle	Brief
air	früh
airinōn	Gesandter sein
airis	längst, eher, früher
airiza	Vorfahre
aírknis	heilig
aírkniþa	Lauterkeit, Echtheit, Reinheit
aírkns	heilig
airmans	groß, gewaltig
aírþa	Erde, Land, Erdreich, Erdboden
aírþakunds	von irdischer Abkunft, von der Erde stammend, irdisch
aírþeins	irdisch, irden
airus	Bote, Gesandtschaft, Abgesandter
aírzei	Irre, Irrlehre, Irrtum
aírzeis	irre geführt, irre, verführt
aírziþa	Irrlehre, Irre, Irrtum
aírzjan	irreführen, irre machen, verführen, Verführer
aiskōn	fragen, fordern
aistan	sich scheuen vor
aiþei	Mutter
aiþs	Eid
aíþþau	oder, wo nicht, sonst, wenigstens
aiw	immer, jederzeit
aíwaggēli	Evangelium, frohe Botschaft
aíwaggēlista	Evangelist
aíwaggēljan	das Evangelium verkünden
aíwaggēljō	Evangelium, frohe Botschaft
aiweins	ewig
aiwiski	Schande, Schmach
aiwiskōn	schändlich handeln
aiwisks	schändlich
aíwlaúgia	Segen, Spende
aiws	Zeit, Ewigkeit
aíwxaristia	Dank, Danksagung
aiz	Erz, Erzmünze
aiza	Scheu, Achtung, Ehre
aizasmiþa	Erzschmied, Metallarbeiter
ajukdūþs	Ewigkeit
ajuks	ewig
ak	sondern, aber, geh
akan	gehen, fahren, ziehen
akei	aber
akēt	Essig
akran	Frucht, Ertrag
akranalaus	kornlos, fruchtlos, unfruchtbar
akrs	Acker
ala	all, ganz, völlig
alabalstraún	Salbenbüchse
alabrunsts	Brandopfer
alakjis	gesamt
alakjō	insgesamt, gesamt, zusammen
alamans	Gesamtheit der Menschen, alle Menschen
alan	wachsen, sich nähren, aufwachsen
alaþarba	alldarbend, an allem Mangel leidend, ganz arm
alauds	Allod, Vollgut, Gut
albs	Alb, Dämon
alda	alt
aldōmō	Alter
aldr	Alter
alds	Menschenalter, Zeit
alduma	alt
aleina	Elle
alēw	Öl
alēwabagms	Ölbaum
alēwja	Öl
alh	Gott
alhs	Tempel, Hain
ali	andere
alisi	Erle
alisna	Ahle
alisō	Erle
aliþs	gemästet
aliza	Erle
alja	außer
aljakuns	anderswoher stammend, gegen die Natur, von einem anderen Geschlecht, von fremder Abkunft, fremd
aljaleikō	anders
aljaleikōþs	anders gebildet, allegorisch, bildlich, anders gemeint
aljaleiks	andere
aljan	mästen
aljan	Eifer
aljanōn	eifern, eifern für
aljar	anderswo
aljaþ	anderswohin
aljaþrō	anderswoher
aljis	andere
allandjis	völlig
allandjō	völlig, vollständig, ganz und gar
allaþrō	von allen Seiten
allawaúrstwa	allwirkend, vollkommen
allawērei	Redlichkeit
allawēreis	redlich
allis	überhaupt, denn
alls	all, jeder, ganz, viel
allwaldands	allmächtig, Allmächtiger, Allwaltender
alþan	altern, alt werden
alþeis	alt
amals	tapfer, tätig
amen	amen
ams	Schulter
an	denn, nun
ana	darauf, außerdem, an, auf, in, über
ana	Ahne, Vorfahre
anaaukan	hinzufügen zu, fortfahren
anabiudan	entbieten, befehlen, anordnen
anabūsns	Gebot, Befehl
anadrigkan	antrinken, betrinken
anafilh	Anvertrautes, Empfehlung, Überlieferung
anafilhan	übergeben, überliefern, verpachten, empfehlen, anempfehlen, geben
anagaggan	kommen, künftig sein
anahaban	besitzen, innehaben
anahaimeis	in der Heimat befindlich, daheim, zuhause
anahaitan	anrufen, bitten, schelten
anahamōn	die Bekleidung anlegen, anziehen
anahaspan	aufhaspeln
anahnaiwjan	niederlegen
anahneiwan	sich niederbeugen, sich neigen, sich bücken
anaƕeilan	beruhigen, erquicken
anainsakan	auferlegen, hinzufügen
anakaúrjan	beschweren
anaks	plötzlich, sogleich
anakumbjan	sich niederlegen, zu Tisch legen, lagern
anakunnains	Lesung
anakunnan	lesen
analageins	Auflegung
analagjan	einlegen, auflegen, beibringen
analatjan	verhindern, hindern, aufhalten, abhalten
analaugnei	Verborgenheit
analaugniba	im geheimen, heimlich, verborgen
analaugns	verborgen
analeikō	auf gleiche Weise, gleichermaßen
analeiks	ähnlich, gleich
anamahtjan	vergewaltigen, rauben, kränken, quälen, erpressen, misshandeln, beleidigen, schmähen, Gewalt antun, Unrecht antun
anamahts	Übermacht, Misshandlung
anamēljan	aufschreiben, sich in die Steuerlisten eintragen lassen
anaminds	versteckte Meinung, Vermutung
anan	atmen, hauchen
ananamnjan	benennen, nennen, rufen
anananþjan	Mut fassen, sich erkühnen, wagen
ananauþjan	durch Zwang veranlassen, nötigen, zwingen
ananiujan	erneuern, sich erneuern, erneuert werden
ananiujiþa	Erneuerung
anapraggan	bedrängen, bedrücken
anaqal	Ruhe, Beruhigung
anaqilan	zur Ruhe kommen
anaqiman	hinzutreten zu, hinzukommen
anaqiss	Lästerung, Schmährede
anaqiþan	verleumden, verlästern, schmähen
anaqiujan	beleben, erwecken, lebendig machen
anasilan	still werden, nachlassen, verstummen
anasiuniba	sichtbar
anasiuns	sichtbar
anaslawan	verstummen, still werden
anaslēpan	einschlafen, entschlummern, entschlafen
anastōdeins	Anfang
anastōdjan	anfangen, anheben, beginnen
anatimrjan	aufzimmern, daraufbauen, aufbauen
anatjan	zwingen
anatrimpan	bedrängen, drängen, hinzutreten, zudrängen
anaþaíma	Fluch, Verfluchter
anaþiwan	unterjochen, in Dienstbarkeit bringen, dienstbar machen
anaþrafstjan	trösten, erquicken
anawaírþs	zukünftig
anawammjan	beflecken, tadeln
anawiljei	Billigkeit, Ehrbarkeit
anawiljis	ehrbar, redlich
and	entlang, über ... hin, auf ... hin
anda	Ende
andabaúhts	Gegenkauf, Lösegeld
andabeit	Tadel
andahafts	Antwort, Verteidigung
andahait	Bekenntnis
andalauni	Gegenlohn, Vergeltung
andanahti	Abend
andaneiþa	feindlich
andaneiþs	widrig, entgegengesetzt, feindlich, im Gegenteil
andanēm	Entgegennahme, Empfang, Empfangen, Annahme
andanēmeigs	entgegennehmend, festhaltend
andanēms	angenehm
andanumts	Annahme, Aufnahme, Erhebung
andasēts	verabscheuenswert, verabscheuenswürdig
andastaþjis	Entgegenstehender, Widersacher
andastaua	Gegner vor Gericht, Widersacher
andaþāhts	nüchtern, verständig, vernünftig
andaugi	Antlitz, Gesicht
andaugiba	offen, freimütig
andaugjō	offen, offenbar, öffentlich
andawaírþi	Gegenwert, Preis
andawaúrdi	Antwort
andawizns	Notdurft, Unterhalt, Sold
andawleizn	Angesicht, Antlitz, Gesicht
andawliti	Antlitz, Gesicht, Angesicht
andbahti	Amt, Dienst
andbahtjan	leisten, dienen, besorgen, darreichen
andbahts	Diener
andbeitan	schelten, bedrohen, in Verlegenheit geraten, tadeln, anfahren
andbindan	entbinden, lösen, auflösen, erklären, losbinden
andbundnan	entbunden werden, gelöst werden
andeis	Ende
andhafjan	erwidern, antworten, entgegnen
andhaitan	bekennen, preisen, erklären
andhamōnsik)	entkleiden, ausziehen
andhausjan	gehorchen, erhören, erhört werden
andhruskan	nachforschen, prüfen, untersuchen
andhuleins	Enthüllung, Offenbarung
andhuliþs	enthüllt, unverhüllt
andhuljan	enthüllen, abdecken, entblößen, offenbaren
andi	Geist
andilaus	endlos
andizuh	anders, sonst, entweder
andjan	enden, endigen
andlētan	entlassen
andlētnan	scheiden, abscheiden, entlassen werden, aufgelöst werden, sich auflösen, sich losmachen
andniman	annehmen, aufnehmen, genießen, empfangen, wieder empfangen, erhalten
andqiþan	entsagen, Abschied nehmen, entlassen, zusammenkommen mit, sprechen mit, sprechen, Lebewohl sagen
andrinnan	entgegenrennen, streiten
andsaíƕan	auf etwas sehen, berücksichtigen, achtgeben, ansehen, in Betracht ziehen, beachten
andsakan	widersprechen, bekämpfen, bestreiten
andsakans	bestritten
andsaljan	darbringen, opfern
andsitan	scheuen, Rücksicht nehmen
andsōks	widerleglich, bestreitbar
andspeiwan	entgegenspeien, ausspeien, verachten, verwerfen
andstald	Darbietung, Beistand, Darreichung
andstaldan	versehen, darreichen
andstandan	entgegenstehen, widerstehen, widerstreiten, widerstreben
andstaúrran	Unwillen zeigen, widerspenstig sein, anstarren, murren
andtilōn	anhangen, sich annehmen, dienen, helfen, beistehen
andþagkjansik)	einfallen, erinnern, gedenken, sich besinnen, überlegen, bedenken, sich entsinnen
andwaírþi	Gegenwart, Angesicht, Person, Gesicht
andwaírþis	gegenüber
andwaírþō	sofort
andwaírþs	gegenwärtig
andwasjan	entkleiden
andwaúrdjan	widersprechen, antworten
andweihan	widerstreiten, ankämpfen, entgegenkämpfen
anetiare	zwingen
annō	Sold, Kosten
ans	Balken
ans	Götter
anses	Halbgötter
ansteigs	gnädig, günstig
ansts	Freude, Dank, Gnade, Gunst, Gnadengabe
ansula	kleiner Ase, kleiner Gott
ansus	Ase, Gott
ant	Riese
anþar	andere, zweite
anþarleikei	Verschiedenheit
anþarleikō	anders
anþarleiks	verschieden
anþs	Spitze, Ende
anþs	Geist, Seele
apaústaúlei	Apostolat
apaústaúlus	Apostel, Bote, Abgesandter
apls	Apfel
aqizi	Axt
ara	Aar, Adler
Arabia	Arabien
arbaidjan	arbeiten, dulden, kämpfen für
arbaiþs	Arbeit, Drangsal, Hemmung, Bedrängnis
arbi	Erbe, Erbschaft
arbinumja	Erbnehmer, Erbe
arbja	Erbe
arbjō	Erbin
arca	Grenzwall
areinsdags	Dienstag
arga	Feigling, Elender
args	feige, elend
arh	Pfeil
arha	Pfeil
arƕa	Pfeil
arƕazna	Pfeil
arjan	pflügen, ackern
arjausdags	Dienstag
arka	Arche, Kasten, Futteral, Beutel, Geldkasten
arkaggilus	Erzengel
armahaírtei	Barmherzigkeit
armahaírtiþa	Almosen, Barmherzigkeit
armahaírts	barmherzig
armaiō	Barmherzigkeit, Almosen
arman	sich erbarmen, bemitleiden
arms	arm, beklagenswert, bemitleidenswert
arms	Arm
arneis	sicher
arniba	sicher, gewiss
arōmata	Spezereien, Gewürze
arþ	Wohnsitz, Aufenthalt
arus	bereit, flink
arwjō	umsonst, unentgeltlich, ohne Ursache, vergebens
asans	Sommer, Erntezeit, Ernte
Asia	Asien
asiluqaírnus	Eselsmühle, Mühlstein
asilus	Esel, Eselin
aska	Äsche
asks	Esche, Speer
asneis	Mietling, Tagelöhner
asnō	Lohn, Zins
aspa	Espe
assarjus	Ass
astaþ	Sicherheit, Gewissheit
asts	Ast, Streu von Laub, Zweig, Palmzweig
at	von, bei, an, zu, unter, auf
ataþni	Jahr
ataugjan	zeigen, erscheinen
atbaíran	bringen, herbeibringen, darbringen, hinzutragen
atdragan	herunterziehen
atdriusan	fallen in, zufallen, fallen
atfarjan	einlaufen, landen
atgagg	Zugang
atgaggan	hinzugehen, kommen, hinzukommen
atgāhts	Eingang
atgāhts	zugänglich
atgaraíhtjan	vollends in Ordnung bringen, wiederherstellen, einrichten
atgiban	hingeben, übergeben, geben, darreichen
athabansikdu)	anhalten, nähern
athafjan	herabheben, herabnehmen
athāhan	hinabhängen, hinablassen, hinunterlassen, niederlassen
athaitan	herzurufen
atisk	Saat, Saatfeld
atjan	essen lassen
atkunnan	gewähren, zuerkennen
atlagjan	hinlegen, auflegen, Geld anlegen, legen, werfen, aufsetzen
atlaþōn	berufen
atlēweins	Verrat
atlēweis	Verräter
atligan	dabeiliegen, vorliegen, vorhanden sein
atnēƕjan	herannahen
atniman	aufnehmen, versetzen, annehmen
atochta	schlecht
atrinnan	hinzulaufen, hinzurennen
atsaíƕan	sehen auf, sich in Acht nehmen, sich hüten
atsatjan	darstellen
atsnarpjan	anfassen, anrühren, berühren, angreifen
atsniwan	hinzueilen
atstandan	dabeistehen, eintreten, hinzukommen, hinzutreten, zugegen sein
atsteigan	hinabsteigen
atta	Vater, Vorfahre
attēkan	berühren, anrühren
attiuhan	herbeiziehen, herbeiführen, herbeibringen, hereinführen, bringen
atþinsan	heranziehen, herbeiziehen, herzuziehen
atugs	schlecht
atwaírpan	hinwerfen, hinstrecken, werfen
atwalwjan	hinzuwälzen, hinwälzen
atwandjan	zuwenden, zurückkehren
atwisan	da sein, zur Hand liegen
atwitains	Beobachten, Beobachtung, Wahrnehmung
atwitan	beobachten
atwōpjan	herbeirufen
aþal	Adel
aþals	edel
aþans	edel
aþn	Jahr
aþþan	aber doch, aber ja, aber nun, denn, also, nun, und
audagei	Seligkeit
audagjan	selig preisen
audags	vom Schicksal begabt, selig
audahafts	beglückt, begnadigt, beseligt, selig
audsauþs	Habe, Gut
aúftō	allerdings, wohl, vielleicht, etwa
augadaúrō	Augentür, Fenster
augjan	zeigen
augō	Auge
áuhjōdus	Lärm
auhjōn	lärmen, schreien
aúhns	Ofen
aúhsa	Ochse, Rind
aúhsus	Ochse, Rind
aúhuma	höher, erhaben, vorzüglicher
auja	Glück
auk	denn, nämlich, aber, auch, und
aukan	sich mehren, sich vermehren
auknan	sich mehren, dargebracht werden
aur	Sand, Kies
aur	Meer
aurahi	Grabdenkmal, Grab, Grabmal
aurahs	sandig, kiesig
aúrāli	Schweißtuch
aúrkeis	Krug
aúrtigards	Garten
aúrtja	Landmann, Winzer
aúrts	Garten
aus	weibliches Schaf, Mutterschaf
aus	glänzend, hell, morgendlich
ausahriggs	Ohrring
ausō	Ohr
austra	Osten
Austrogoti	Ostgoten
auþeis	öde, kinderlos, unfruchtbar, wüst, verlassen
auþida	Wüste, Einöde
awa	Großvater
awēþi	Schafherde
awi	Au
awi	Glück, göttlicher Schutz
awi	gut
awiliudōn	danken, preisen
awiliuþ	Dank, Danksagung, Gnade
awistr	Schafstall
awō	Großmutter
aza	aRune
azētaba	leicht, gern
azēti)	Leichtigkeit, Vergnügen, Lust, Annehmlichkeit, zRune
azēts	leicht, erträglich
azgō	Asche
azwmus	ungesäuertes Brot
b	b, Abkürzung für 2
ba	wenn
badi	Bett
badu	Kampf
baggwiþa	Wohnung
bagks	Bank
bagms	Baum
bai	beide
bai	wenn
baidjan	zwingen, nötigen
baira	Bär
baírabagms	Maulbeerbaum
baíran	tragen, leiden, erleiden, gebären, ertragen
baírga	Berge
baírgahei	Gebirgsgegend, Berggegend, Gebirge
baírgahs	bergig, gebirgig
baírgan	bergen, bewahren, erhalten
bairgō	Berge
baírgs	Berg
baírhtaba	hell, glänzend, deutlich, offen
baírhtei	Helle, Offenbarung, Klarheit, Verkündigung
baírhteins	Erscheinung
baírhtjan	offenbaren
baírhts	hell, offenbar, deutlich
baírka	Birke
baitraba	bitter
baitrei	Bitterkeit
baitrs	bitter
bajōþs	beide
bala	Pferd mit Blesse
balgbrust)	Balgbersten
balgs	Balg, Schlauch, Tasche
bals	weiß
balsan	Salbe, Balsam
balþaba	kühn, freimütig
balþei	Kühnheit, Freimut, Freimütigkeit, Unerschrockenheit
balþjan	kühn sein, wagen
balþs	geschwollen, kühn
balu	Unglück, Übel
balus	böse, übel
balwaweis	böse, übel
balwawēsei	Bosheit
balweins	Pein, Strafe, Folter, Qual
balwjan	martern, quälen, plagen
bandi	Band
bandja	Gefangener, Gebundener
bandwa	Zeichen
bandwjan	ein Zeichen geben, Wink geben, andeuten, bezeichnen
bandwō	Zeichen, verabredetes Zeichen
banja	Schlag, Wunde, eiternde Wunde, Geschwür
bannwīda	Bannweite
bansts	Scheuer, Scheune
bara	Mann
barbarus	Nichtgrieche, Barbar, Ausländer, Fremder
bards	Bart
bards	Riese
baris	Gerste
barizeins	von Gerste bereitet, gersten, Gersten...
barms	Busen, Schoß, Brust
barn	Kind
barnahs	bekindet
barnilō	Kindlein, Kindchen, Knäblein
barniskei	kindliches Wesen, Kinderei
barniski	Kindheit
barnisks	kindlich, kindisch
barsiks	Barsch
barusnjan	fromm verehren, verehren, kindlich ehren
bas	bar, bloß
basi	Beere
bata	Nutzen, Vorteil
batis	gut, bessere
batiza	bessere
batnan	besser werden
báuains	Wohnung
báuan	wohnen, bewohnen
baudes	Gebieter
baugjan	fegen
baugs	Ring
bauljan	blasen
bauljō	Blase, Beule
baúr	Geborener
baúrans	geboren
baúrd	Brett
baúrd	Bord, Rand
baúrgja	Bürger
baúrgjan	bergen
baúrgs	Turm, Burg, Stadt
baúrgswaddjus	Stadtmauer
baúrjōþus	Lust
baurs	Wind
baúrsti	Bürste
baurtils	Bürzel
baúrþei	Bürde, Last
baúrþs	getragen
bausei	Bosheit, List, Betrug
bautan	stoßen, schlagen, werfen
bauþs	stumm, taub, dumm, dumpf
bawiþa	Hütte, Bau
bazjan	leeren, entkräften, entblößen
bēga	Streit
beidan	warten, erwarten
beist	Sauerteig, Biestmilch
beistei	Gesäuertes, Gesäuertsein
beistjan	säuern
beistjōþs	gesäuert
beitan	beißen
bel	Streitaxt, Bär
belagines	Recht
bercna	Birkenreis, bRune
bērs	Eber
bērusi	Gebärende, Mutter
bērusjōs	Eltern
bi	um, herum, an, in, innerhalb, inbetreff, über, gemäß, bei, nach, betreffs, zu
biabrjan	außer sich geraten über, sich entsetzen, heftig werden
biarbaidjan	trachten nach, sich bemühen
biaukan	hinzufügen
biauknan	sich vermehren, zunehmen
bibaúrgeins	Lager
bibaúrgjan	bergen, zur Stadt machen, befestigen
bibindan	umbinden, umwickeln
bida	Bitte, Gebet, Aufforderung
bidagwa	Bettler
bidan	bitten
bidjan	bitten, beten, betteln
bidōmjan	verurteilen
bifaih	Übervorteilung
bifaihōn	übervorteilen
bifaihōns	Übervorteilung
bigaírdan	umgürten
bigardio	Gehege, Garten
bigitan	finden, antreffen, auffinden
bigraban	mit einem Graben umgeben
bihait	üble Nachrede
bihaitan	prahlen, verleumden
bihaitja	Prahler, streitsüchtiger Mensch
bihlahjan	verlachen, verspotten, auslachen
biƕaírban	umdrängen
biƕē	woran
bijandzuþþan	zugleich aber auch
bikukjan	mit Küssen bedecken
bilageins	Gesetz
bilagjan	auferlegen
bilaibjan	übriglassen
bilaif	Überrest, Rest
bilaigōn	belecken, ablecken
bilaikan	verspotten
bilaistiþs	aufspürbar, erforscht, begreiflich
bileiban	bleiben
bileiþan	verlassen, zurücklassen, hinterlassen
bilgan	schwellen
bilisa	Bilsenkraut
bimait	Beschneidung
bimaitan	beschneiden
bimampjan	verhöhnen, verspotten
binaúhan	dürfen, erlaubt sein
binda	Binde, Band
bindan	binden
biniman	wegnehmen, stehlen
biniuhsjan	auskundschaften, ausspionieren, ausforschen
biqiman	überfallen
biraubōn	berauben, ausziehen
bireikei	Gefahr
bireikeis	gefährdet
birinnan	umringen, herumlaufen, durchstreifen, umdrängen, umgeben, umherlaufen
birōdeins	Murren, Verleumdung
birōdjan	murrend reden, murren
birūnains	Nachstellung, Anschlag
birūnan	leise sprechen, sich verschwören, beschließen
bisaíƕan	umsehen, ansehen, bemerken, sorgen für, sich vorsehen, erkennen, betrachten
bisatjan	umgeben
bisauleins	Befleckung
bisauljan	besudeln, beflecken
bisaulnan	besudelt werden, befleckt werden, verunreinigt werden
bisitan	herumsitzen, herumwohnen, umwohnen, nahe wohnen
biskaban	schaben, scheren, Haare abschneiden
biskeinan	umleuchten
bismeitan	bestreichen, beschmieren, aufstreichen
bisniwan	zuvorkommen, zuvoreilen
bispeiwan	bespeien, anspeien
bistandan	herumstehen, umringen
bistigqan	anstoßen, anprellen
bistugq	Anstoß
bisunjanē	ringsum
bisuus	geschäftig
biswaírban	abwischen, abtrocknen
biswaran	beschwören
bitiuhan	umherführen, umherziehen, durchziehen, mitführen, durchwandern
biþagkjan	bedenken, überlegen
biþē	nachher, später, während, als, sobald als, nachdem, da
biþragjan	herbeilaufen, vorauslaufen, hinzulaufen
biþwahan	abwaschen, waschen
biudan	bieten, entbieten
biugan	beugen, sich beugen
biūhti	Gewohnheit
biūhts	gewohnt
biuþs	Tisch, Platte
biwaibjan	umwinden, umgeben, umkleiden
biwandjan	vermeiden
biwindan	umwinden, einwickeln, umwickeln, in Windeln wickeln
biwisan	sich erfreuen, sich vergnügen
blagks	weiß, glänzend
blandansik)	sich vermischen mit, mischen
blas	Fackel, Flamme
blauts	bloß
blauþjan	abschaffen, aufheben
blauþs	schwach, kraftlos
bleis	farbig
bleiþei	Wohlwollen, Güte, Mitleid, Erbarmen
bleiþeins	Erbarmen, Mitleid
bleiþjan	barmherzig sein, sich erbarmen, Mitleid hegen
bleiþs	dem Guten zugetan, barmherzig, fromm, gütig, mild, mitleidig
blēsan	blasen
blēsi	Fackel, Feuer
blēsjan	versengen, ätzen
blēstjan	blasen, schnauben
blēsts	Blasen, Schnauben
bliggwan	schlagen
blindjan	blenden
blindnan	erblinden, blind werden
blinds	blind
blōma	Blume, Lilie
blōstr	Opfer
blōstreis	Verehrer
blōtan	verehren, opfern
blōteins	Verehrung
blōtinassus	Verehrung, Gottesverehrung
blōþ	Blut
blōþarinnands	blutflüssig
blunds	blond
bnáuan	zerreiben
boga	Bogen
bōka	Buchstabe, Schrift
bōkāreis	Schriftgelehrter, Schreiber
bōta	Nutzen
bōtjan	nützen, bessern
braƕ	Braue, Zwinkern, Blick
braidei	Breite
braidjan	breiten
braiƕan	strahlen, glänzen
braiþs	breit
brakja	Ringen, Ringkampf, Kampf
bramjan	brüllen
brammōn	brüllen
branda	Feuerbrand, Brand
brands	Brand
brands	Schwert
brannjan	verbrennen
brasa	glühende Kohle
brasōn	braten
brauþ	Brot
breen	schmoren
breuwan	wallen, sieden
bridila	Brettchen, Schemel
brigdil	Zügel
briggan	bringen, führen machen
brikan	brechen, zerstören, kämpfen, ringen, zerbrechen, vernichten
brinnan	brennen
brinnō	Fieber
bristan	bersten, brechen
briþ	Brett
broe	Brot
brōjan	brühen
broks	Hose
brōþar	Bruder
brōþrahans	Brüder
brōþrahs	brüderlich
brōþrulubō	Bruderliebe
brugdjan	schwingen, bewegen
bruka	Brocken
brukja	Brocken
brūkjan	gebrauchen, brauchen, anwenden
bruknan	gebrochen werden
brūks	brauchbar
brunjō	Brustharnisch, Brünne
brunna	Brunnen, Quelle, Born
brūns	braun, glänzend
brunsts	Brennen, Brand
brust	Bersten
brusti	Bürste, Striegel
brustjan	sprossen
brusts	Brust,, Herz, Gemüt
brutilō	Spross
brutōn	knospen
bruts	Knospe
bruþ	Brühe
brūþfaþs	Brautführer, Bräutigam, Hochzeiter, Brautgemach
brūþs	Neuvermählte, Schwiegertochter, junge Frau
bruzdōn	sticken
buggja	Knolle, Schwellung
bugjan	kaufen, verkaufen
būks	Bauch
Bulgar	Bulgar
bundnan	gebunden werden
būrjō	Gebäude
būska	Scheit
būsns	Gebot
bwssaún	feines Linnen, feine Leinwand
cadariou	Soldat
contropare	vergleichen
contropatio	Vergleich
criten	weinen
d	d, Abkürzung für 4
daban	sich ereignen, passen
daddjan	säugen
dagis	tags
dags	Tag, dRune
daigs	Teig
daila	Teilnahme, Gemeinschaft, Mine, Pfund
dailjan	teilen, einem zuteilen, mitteilen
dails	Teil, Anteil
daimōnāreis	Besessener
dalaþ	zu Tal, abwärts, nieder, herab, hinunter, hinab
dalaþa	unten
dalaþrō	von unten, unten
dals	Grube, Schlucht, Tal
dammjan	dämmen
damms	Damm
Danila	Dänlein
Dans	Däne
Danus	Däne
darnjan	verheimlichen
darns	zauberisch
daubei	Taubheit, Verhärtung, Verstocktheit
daubiþa	Verstocktheit, Verhärtung, Taubheit
daubjan	taub sein, verstocken
daubnan	verstockt werden, taub werden
daufs	taub, verstockt
daúhtar	Tochter
daúhts	Bewirtung, Mahl, Gastmahl, Mahlzeit
dauka	Erdhöhle, Wohnung
dauns	Geruch, Wohlgeruch, Dunst
daupeins	Abwaschung, Taufe, Waschung
daupjan	taufen, tauchen, sich taufen lassen
daupjands	Täufer
daúr	einflügeliges Tor, Tür, Pforte
daúrawarda	Türhüterin, Pförtnerin
daúrawardō	Türhüterin, Pförtnerin
daúrawards	Torwart, Türhüter
daúri	Tor
daúrō	zweiflügeliges Tor, Tür, Pforte
daúrsan	wagen
dauþeins	Absterben, Sterben, Tod, Todesgefahr
dauþjan	töten
dauþnan	sterben
dauþs	tot
dauþubleis	zum Tode bestimmt, dem Tode geweiht, zum Tode verurteilt
dauþus	Tod
dēdja	Täter
deinō	Distel
deis	weise, klug
deisei	Schlauheit
dēþs	Tat
diabaúlus	Teufel
diabula	Verleumderin
diakaúnus	Diakon, Pfleger
digan	kneten, aus Ton bilden, bilden, formen
digrei	Fülle
digrs	voll, zusammengeknetet, dicht
dis	zer..., auseinander..., ver...
disdailjan	verteilen, zerteilen, teilen
disdriusan	befallen
dishaban	ergreifen, behalten, festhalten
dishniupan	zerreißen
dishnupnan	zerreißen, zerrissen werden
dishuljan	verhüllen, bedecken
disks	Tisch
disniman	besitzen
dissigqan	untersinken, untergehen, sinken
dissitan	ergreifen, überfallen
disskaidan	zerteilen
disskreitan	zerreißen
disskritnan	zerreißen
distaheins	Zerstreuung
distahjan	zerstreuen, vergeuden, verschwenden
distaíran	zerreißen, auseinanderzerren, verderben
distaúrnan	zerreißen
diswidan	auflösen
diswilwan	ausplündern, berauben, plündern
diswinþjan	auseinanderwerfen, zermalmen, worfeln, zerstreuen
diswiss	Auflösung, Abmarsch, Scheiden
diupei	Tiefe
diupiþa	Tiefe, Meerestiefe
diupjan	vertiefen
diups	tief
dius	wildes Tier, Tier
diwan	sterben
diwanei	Sterblichkeit
dōbnan	verstummen
dōfs	schicklich, passend
dōgs	tägig
dōmeins	Urteil
dōmjan	urteilen, beurteilen, unterscheiden, rechtfertigen, rechnen, meinen
dōms	Urteil, Ruhm
draban	hauen
dragan	tragen, aufladen, ziehen
dragk	Trank
dragkjan	tränken, tränken mit
draibjan	treiben, plagen, antreiben
drakma	Drachme
draúhsna	Brocken, Brosamen, Bissen
draúhtinassus	Feldzug, Kriegsdienst
draúhtinōn	Kriegsdienste tun, zu Felde ziehen, sammeln, dienen
draúhtins	Führer, Herrscher
draúhtiwitōþ	Feldzug, Kriegsrecht, Kriegsdienst
draúhts	Heer, Schar, Gefolge, Volk
drausjan	stürzen
dreiban	treiben
drigkan	trinken
driugan	zu Felde ziehen, kämpfen, Kriegsdienste tun
driusan	fallen, herabfallen
driusō	Abhang
drōbjan	trüben, irre machen, aufwiegeln, bewegen, erschüttern, aufregen
drōbjis	trüb
drōbna	Aufruhr, Aufstand
drōbnan	unruhig werden, erschüttert werden, sich beunruhigen
drugkanei	Trunkenheit
drugkja	Trinker
drugks	Trank
drunjus	Schall
drus	Fall
drūþs	traut, lieb
du	zu, nach ... hin, für, in
duatgaggan	hinzugehen, hinzukommen zu
duatrinnan	hinzurennen, hinzulaufen
duatsniwan	hinzueilen
dūbō	Taube
dugan	taugen, nützen
dugawindansik)	sich verwickeln, sich verstricken
duginnan	beginnen, anfangen, versuchen,
duƕē	wozu, warum
dulgahaitja	Schuldheischer, Gläubiger
dulgs	Schuld
dulþjan	ein Fest feiern
dulþs	Fest, Osterfest
dumbnan	verstummen
dumbs	stumm
durinnan	hinzulaufen, hinzurennen
dustōdjan	anfangen, anheben
dūþē	deshalb, deswegen, weil, damit, dazu, darum dass
dwalawaúrdei	Torenrede, törichtes Gerede
dwalawaúrds	töricht redend
dwaligōn	betrügen
dwaliþa	Torheit
dwalmōn	rasen
dwalms	Verzückung, Betäubung
dwals	töricht
dwilan	säumen, betäuben
e	e, Abkürzung für 5
ei	da, so, in dem Fall, bei dem Umstand, dass, damit, ob, und
eigs	ig
eis	Eis, iRune
eisarn	Eisen
eisarnabandi	Eisenband, Kette
eisarneins	eisern
eiþan	daher, somit, nun
ela	Ahle
ēmaitja	Ameise
enguz	Iggws, Speer, Mann, nRune
era	Ära, Zeitabschnitt
erls	Mann, edler Mann
ēt	Essen
ēta	Esser
ētja	Esser
ēts	essend
eyz	Pferd, eRune
ezec	leicht, zRune
fadar	Vater
fadrein	Abkunft, Geschlecht, Stamm, Eltern, Großeltern, Vorfahren
fadreins	Geschlecht
fadreins	väterlich
faginōn	sich freuen
fagins	froh
fagrs	passend, geeignet, geschickt
fāh	Fang
fāhan	fangen, greifen
fahēþs	Freude
fahrjan	zubereiten
fahs	fröhlich, froh
fáian	tadeln
faihan	sich freuen
faihs	bunt
faíhu	Vieh, Vermögen, Geld, fRune
faíhufrikei	Habsucht, Gewinnsucht, Geldgier
faíhufriks	habsüchtig, geldgierig, gewinnsüchtig
faíhugaírnei	Habsucht, Habgier
faíhugaírns	geldgierig, habsüchtig
faíhugawaúrki	Erwerb, Geldgewinn, Gewinn
faíhugeigan	begehren, habgierig sein
faíhugeirō	Habsucht, Habgier, Geldgier
faíhugeirs	habgierig, habsüchtig
faíhuskula	Schuldner
faíhuþraihn	Viehansammlung, Geldansammlung, Reichtum
faír	ver, ent, er
faíraihan	teilhaben an
faírgreipan	ergreifen, greifen
faírguni	Berg, Gebirge
faírhaitan	verheißen, Dank wissen
faírƕus	Welt
faírina	Schuld, Vorwurf, Grund, Ursache, Anklagegrund, Beschuldigung
faírina	tadelig, unrecht
faírinōdaba	tadelig
faírinōn	tadeln, beschuldigen
faírinōþs	schuldig, tadelig, bescholten
faírins	tadelig, unrecht
faírjan	abreisen, weggehen, sich wegbewegen
faírlaistiþs	aufspürbar, erforschlich
faírneis	alt
faírniþa	Alter
faírns	vorjährig, alt
faírra	fern, fern von, weg von
faírraþrō	von fern
faírrinnan	sich erstrecken, reichen zu
faírwaúrkjan	erwirken
faírweit	Hinblick, Aufmerken, Neugier
faírweitan	angestrengt sehen
faírweitjan	hinblicken, gaffen, umherspähen, spähen
faírweitl	Schauspiel
faírzna	Ferse
falda	Falte
falka	Falke
falþ	fältig
falþaba	fältig
falþan	falten, zusammenrollen, zusammenlegen
falþei	fältigkeit
falþs	fältig
falwiska	Flugasche, Funke
falws	fahl, falb, gelblich, grau
fana	Stück Zeug, Zeugstück, Lappen, Tuch, Schweißtuch
fani	Schlamm, Kot
fanþja	Fußsoldat
fara	Fahrerin, Fahrt
faran	wandern, ziehen, fahren, gehen
Faraō	Pharao
Fareisaius	Pharisäer
farjan	fahren, schiffen
farþa	Fahrt, Reise
farwa	Farbe, Aussehen, Gestalt
faskja	Binde
fasta	Fasten
fastan	halten, festhalten, beobachten, bewachen, fasten
fasteis	Kundiger
fastnēms	sparsam
fasts	fest
fastubni	Halten, Dienst, Fasten, Haltung, Gottesdienst
fata	Umfassung, Kleiderbündel, Fetzen
faþa	Zaun, Scheidewand
faþs	Herr, Führer
faúhō	Füchsin, Fuchs
faúr	vor, längs, für, inbetreff, um willen, über
faúra	vor, für, vorn, längs, vorher
faúradaúri	Straße, Gasse
faúrafilli	Vorhaut
faúragagga	Vorgänger, Hausverwalter, Verwalter, Vorsteher
faúragaggan	vorangehen, vorstehen
faúragaggi	Verwaltung, Haushaltung, Vorsteheramt
faúragaggja	Verwalter, Vorsteher
faúragahaitan	zuvor verheißen
faúragahugjan	vorherdenken, sich vornehmen
faúragaleikan	vorher gefallen
faúragamanwjan	vorherbereiten, vorher zubereiten
faúragamēljan	vorherschreiben, verkünden
faúragaraidjan	vorherbestimmen
faúragarēdan	vorherbestimmen
faúragasandjan	vorausentsenden, voraussenden
faúragasatjan	vorsetzen, vorstellen, darstellen
faúragateihan	vorherverkünden, vorhersagen
faúrahāh	Vorhang
faúrahāhan	vorhängen
faúramanwjan	vorbereiten
faúramaþleis	Vorsteher, Gebieter, Sprecher
faúramaþli	Oberbefehl, Vorsteheramt
faúramēljan	vorzeichnen, vormalen, vor Augen malen
faúraqiman	vorgehen, vor jemand hergehen
fauraqiþan	vorhersagen
faúrarahnjan	übertreffen
faúrastandan	dabeistehen, vorstehen
faúratani	Wunderzeichen
faúrawēnjan	vorher hoffen
faúrawisan	vorhanden sein
faúrbaúhts	Loskauf, Loskaufung, Erlösung
faúrbigaggan	vorausgehen, vorangehen
faúrbisniwan	vorangehen, zuvorkommen
faúrbiudan	verbieten, gebieten
faúrbjan	reinigen, putzen, glätten
faúrdammjan	verdämmen, versperren, eindämmen, hindern
faúrdōmeins	Vorurteil
faúrdōmjan	vorher urteilen
faúrgaggan	vorübergehen, vorbeigehen
faúrhāh	Vorhang
faúrhāhan	vorhängen
faurhs	Furche
faúrhtei	Furcht, Entsetzen
faúrhtjan	sich fürchten
faúrhts	furchtsam
faúrlageins	Vorlegung
faúrlagjan	vorlegen, vorsetzen
faúrmūljan	das Maul verbinden
faúrqiþan	sich entschuldigen, für ungültig erklären, aufheben, umstoßen
faúrrinnan	vorhergehen
faurs	ehrbar, bescheiden
faúrsigljan	versiegeln
faúrsniwan	vorwegnehmen, vorausgehen, zuvorkommen
faúrstandan	vorstehen
faurstass	Vorstehen, Aufsicht
faúrstasseis	Vorsteher
faúrþis	zuvor, früher, vorher
faúrþizei	bevor, ehe
faúrwaipjan	verbinden
faúrwalwjan	vorwälzen, davorwälzen
faúrweis	vorsätzlich, bedacht
faus	wenig, wenige
fēhaba	anständig, ehrbar
fēhs	anständig
fenea	Gerstengraupen
fēr	Nachstellung
fēra	Seite, Gegend, Glied, Körperteil
fērja	Aufpasser, Nachsteller
fers	Mann
fēteins	Kleidung
fētjan	schmücken
feusa	Speck
fidur	vier
fidurdōgs	viertägig
fidurfalþs	vierfältig, vierfach
fidurragineis	Vierfürst
fidurragini	Vierfürstenamt, Tetrarchie
fidwōr	vier
fidwōrtaíhun	vierzehn
fidwōrþūsundjos	viertausend
figgragulþ	Fingergold, Fingerring
figgrs	Finger
fijan	hassen, verabscheuen
fijands	Feind
fijaþwa	Feindschaft
filaus	um vieles, viel
filhan	verbergen, begraben
filigri	Höhle, Versteck
fill	Fell, Haut
filleins	ledern
fills	häutig
films	Schrecken
filtur	Filz
filu	viel, sehr, um vieles
filudeis	arglistig
filudeisei	Arglist, Schlauheit, List
filufaíhs	sehr bunt, reichhaltig, mannigfaltig
filugalaufs	sehr wertvoll, sehr kostbar
filusna	Vielheit, Menge, Übermaß
filuwaúrdei	vieles Reden, Schwatzhaftigkeit, Geschwätz
filuwaúrdjan	viel Worte machen, viel plappern, viel reden
filuwaúrds	viel redend, viel sprechend
fimf	fünf
fimfhunda	fünfhundert
fimfta	fünfte
fimftaíhun	fünfzehn
fimftataíhunda	fünfzehnte
fimftigjus	fünfzig
fimfþūsunjōs	fünftausend
finja	Gerste
Finnhaiþas	Bewohner von Finnahaithi
finþan	erkennen, erfahren
fiskja	Fischer
fiskōn	fischen
fisks	Fisch
fitan	kreißen, gebären
flahta	Flechte
flaíhtan	flechten
flaskō	Flasche
flautjan	prahlen
flauts	ruhmsüchtig, prahlerisch
flōdus	Strom, Flut
flōkan	betrauern, beklagen
fōdeins	Nahrung, Speise
fōdjan	ernähren, aufziehen
fōdr	Scheide
fōn	Feuer
fōtubandi	Fußband, Fußfessel, Fußschelle
fōtubaūrd	Fußbank, Schemel
fōtus	Fuß
fra	ver...
fraatjan	zum Essen austeilen
frabaíran	vertragen, ertragen
frabaúhtabōka	Verkaufsurkunde
frabugjan	verkaufen
fradailjan	verteilen unter
fragan	fragen
fragiban	vergeben, verleihen, schenken, geben, gewähren
fragifts	Verleihung, Verlobung, Gabe
fragildan	vergelten, erstatten
Fragka	Franke
frahinþan	gefangennehmen, fangen
fraíhnan	fragen
fraisan	versuchen
fraista	Versuchung
fraistōn	versuchen
fraistubni	Versuchung
fraitan	verzehren, fressen
fraiw	Same
frakunnan	verachten
frakunþs	verachtet
fralēt	Erlass, Entlassung
fralētan	lassen, freilassen, entlassen, herablassen, gestatten
fralēts	Freigelassener
fralēwjan	verraten
fraliusan	verlieren
fralusnan	verloren gehen, verloren werden
fralusts	Verderben, Verlust
fram	weiter, von, von ... her, von ... an, an, vor, seit, bei
framaldrs	im Alter vorgeschritten, bejahrt
framaþeis	fremd
framaþjan	entfremden
framgāhts	Fortschritt
framis	weiter
frams	tüchtig
framwaírþis	fernerhin
framwairþs	zukünftig
framwigis	fortwährend, für immer
franiman	nehmen, in Besitz nehmen, in Empfang nehmen, gewinnen
fraqiman	verzehren, ausgeben, vertun, verwenden
fraqisteins	Verderb, Vergeudung, Verschwendung
fraqistjan	verderben, umbringen
fraqistnan	umkommen, zugrunde gehen, verderben
fraqiþan	für ungültig erklären, aufheben, verfluchen, verwünschen
frarinnan	sich verlaufen zu, geraten unter
fraslindan	verschlingen, verschlucken
frastisibja	Kindschaft
frasts	Kind
fraþi	Verstand, Sinn, Gesinnung
fraþjamarzeins	Verstandestäuschung
fraþjan	denken, erkennen, verstehen, merken, verständig sein
fraþjands	verständig
fraþjei	Klugheit, Verstand, Verständigkeit, Besonnenheit
fraþjis	gesinnt
frauja	Herr
fraujinassus	Herrschaft
fraujinōn	herrschen, Herr sein
fraujinōnds	Herrscher, Herr
fraujis	Herr
fraus	froh
fratrudan	treten, trampeln
frawaírpan	verwerfen, zerstreuen, wegwerfen
frawaírþan	verderben, zugrunde gehen
frawardeins	Verderben
frawardjan	verderben, entstellen
frawaúrhts	sündig, Sünder
frawaúrhts	Sünde
frawaúrkjan	sündigen, versündigen, eine Sünde begehen
fraweit	Strafe, Rache
fraweitan	rächen, Recht verschaffen, strafen
frawilwan	fortreißen, gewaltsam ergreifen
frawisan	verbrauchen, vergeuden, verschwenden
frawrikan	verfolgen, rächen
frawrōhjan	verklagen, verdächtigen, verleumden, anzeigen
freideins	Schonung, Erhaltung
freidjan	schonen
freihals	frei
freihals	Freiheit
freis	frei
freiþs	hübsch, schön
friaþwamilds	zärtlich liebend, liebreich
frijaþwa	Liebe
frijei	Freiheit
frijōn	lieben, gern tun
frijōndi	Freundin
frijōnds	Freund
frijōns	Kuss, Liebeszeichen
frikei	Gier, Sucht
friks	süchtig, gierig
frisahtjan	abbilden
frisahtnan	abgebildet werden, Gestalt annehmen
frisahts	Bild, Beispiel, Rätsel, dunkles Bild
frisks	frisch
friþōn	schützen
friþus	Friede, Schutz
frius	Frost, Kälte
friusan	frieren
frōdaba	klug, verständig, weise
frōdei	Klugheit, Verstand
frōþs	klug, verständig, weise
frum	Anfang
fruma	erste
frumabaúr	Erstgeborener
frumadei	Vorrang
frumaþ	vorwärts
frumaþeis	erste
frumei	Anfang
frumist	zuerst
frumisti	Anfang
frumists	der erste
frumjan	fördern, vollbringen
fugls	Vogel
fula	Fohlen, Füllen
fulcus	Volk
fulgins	verborgen
fulhsni	Geheimnis
fulk	Kriegsvolk, Schar
fullafahjan	Genüge leisten, dienen, Genüge tun, befriedigen, zufriedenstellen
fullafraþjan	bei Verstand sein
fullatōjis	vollkommen
fullaweis	vollkommen
fullaweisjan	überreden, überzeugen
fullawita	vollkommen
fullei	Fülle
fulleins	Füllung, Erfüllung
fulleiþs	Fülle, Vollmond
fullja	Fülle, Maß, Fass
fulljan	füllen, anfüllen
fullnan	voll werden, erfüllt werden
fullō	Fülle, Füllung, Flicken, Ausfüllung
fulls	voll, vollkommen
fūls	faul, stinkend
fulþ	Feld
funisks	feurig
funs	bereit, eilig, tapfer
fwnīkisks	phönikisch
fy	590
g	g, Abkürzung für 3
ga	ge..., mit...
gaaggwei	Einschränkung
gaaggweins	Beengung, Einschränkung
gaaggwjan	bedrängen
gaaiginōn	in Besitz nehmen, übervorteilen, in Beschlag nehmen
gaainan	vereinzeln, trennen
gaaistan	sich scheuen vor, achten
gaaiwiskōn	beschämen, beschimpfen
gaandjan	enden, endigen, aufhören
gaar	Jahr, jRune
gaarbja	Miterbe
gaarman	sich erbarmen, bemitleiden
gaaukan	sich vermehren, zunehmen
gabaidjan	zwingen, gebieten, nötigen
gabaíran	zusammentragen, vergleichen, gebären
gabaírgan	bergen, bewahren, erhalten
gabaírhteins	Erscheinung
gabaírhtjan	offenbaren, Gestalt gewinnen, erscheinen
gabandwjan	durch Winke andeuten, ein Zeichen geben, andeuten
gabatnan	Vorteil erlangen, Nutzen erlangen
gabáuan	Wohnung aufschlagen, wohnen
gabaúr	Zusammengebrachtes, Kollekte, Steuer
gabaúr	Festgelage, Schmaus
gabaúrgja	Mitbürger, Mitbewohner
gabaúrjaba	gern
gabaúrjō	erfreulich
gabaúrjōn	sich freuen
gabaúrjōþus	Lust, Vergnügen
gabaúrþiwaurd	Geschlechtsregister
gabaúrþs	Geburt, Abstammung, Geschlecht, Geburtsland
gabei	Reichtum
gabeidan	ausharren, ertragen
gabeistjan	durchsäuern
gabidjan	bitten, beten
gabigaba	reichlich
gabigjan	reich machen, bereichern
gabignan	reich sein
gabigs	reich
gabinda	Band, Binde
gabindan	binden
gabindi	Band
gabiugan	beugen
gablauþjan	abschaffen, triumphieren
gableiþeins	Erbarmen
gableiþjan	sich erbarmen, barmherzig sein
gablindjan	verblenden, blenden
gabōtjan	verbessern, herstellen
gabrannjan	verbrennen
gabrikan	zerbrechen
gabruka	Brocken
gabundi	Band
gadaban	sich ereignen, eintreffen, passen
gadaila	Teilnehmer, Genosse
gadailjan	zuteilen, zerteilen, teilen
gadaubjan	verstocken, verstockt machen
gadauka	Hausgenosse
gadaúrsan	sich erkühnen, wagen, freimütig sein
gadauþjan	Tod bringen, töten
gadauþnan	sterben
gadeltha	schön
gadēþs	Tat
gadigan	kneten, bilden, aus Ton bilden
gadigis	Gebilde
gadiliggs	Vetter
gadiupjan	vertiefen
gadōfs	schicklich, passend
gadōmjan	urteilen, entscheiden, sich vergleichen, sich messen mit
gadraban	aushauen
gadragan	zusammentragen
gadragkjan	tränken mit
gadraúhts	Soldat
gadrausjan	hinabstürzen, niederwerfen, herabwerfen
gadrigkan	trinken
gadriusan	hinfallen, aufhören, fallen
gadrōbnan	in Bestürzung geraten
gafāh	Fang
gafāhan	ergreifen, erfassen, ertappen, fangen
gafahrjan	zubereiten
gafaihan	sich freuen
gafaihōn	übervorteilen, beanspruchen, in Besitz nehmen, täuschen
gafairinōnds	tadelig, bescholten
gafairinōþs	tadelig, schuldig
gafastan	behalten, bewahren, halten
gafaúrds	Versammlung, hoher Rat
gafaurs	ehrbar, nüchtern, besonnen, gesittet
gafēhaba	anständig, ehrbar
gafēhs	anständig, passend, schicklich
gafēteins	Kleidung
gafētjan	kleiden
gafilh	Begräbnis
gafilhan	begraben, verbergen
gafraíhnan	erfragen, fragen, erfahren
gafraþjei	Klugheit, Besonnenheit, Verständigkeit
gafraþjis	klug, vernünftig
gafraujinōn	unterjochen, herrschen
gafreideins	Erhaltung, Bewahrung, Schonung
gafreidjan	erhalten, schonen
gafrijōns	Kuss
gafrisahtjan	abbilden
gafrisahtnan	abgebildet werden, Gestalt annehmen, dargestellt werden
gafriþōn	versöhnen
gafriþōns	Versöhnung
gafulgins	verborgen
gafullaweisjan	beglaubigen, vollenden
gafulljan	erfüllen, füllen, anfüllen
gafullnan	erfüllt werden
gagaggan	zusammenkommen, sich versammeln, kommen, sich begeben, eintreten, ausschlagen
gagahaftjan	zusammenheften, verbinden
gagaleikōn	sich verwandeln, eine Gestalt annehmen
gagamainjan	verunreinigen, entheiligen
gagatilōn	zusammenfügen
gagawaírþjan	versöhnen
gagawaírþnan	sich versöhnen, versöhnt werden
gageigan	gewinnen
gagg	Gang, Weg, Straße
gagga	Gänger, Geher
gaggan	gehen, wandeln, umhergehen, kommen
gaggi	Gehen, Gang
gaggja	Gänger, Geher
gaggjan	gehen, reisen
gagrēfts	Beschluss, Verordnung, Befehl
gagudaba	fromm, gottesfürchtig
gagudei	Frömmigkeit
gaguþs	ehrbar, anständig
gahaban	ergreifen, enthalten, halten, haben, fangen
gahabands	beherrscht
gahaftjan	heften, anhängen
gahaftnan	anhangen, sich anheften
gahafts	zusammengeheftet
gahāhjis	zusammenhängend
gahāhjō	zusammenhängend, im Zusammenhang, der Reihe nach
gahailjan	heilen, herstellen
gahailnan	geheilt werden, hergestellt werden, gesund werden
gahails	ganz unversehrt
gahait	Verheißung, Versprechen
gahaitan	zusammenrufen, verheißen, sich bekennen zu
gahamōn	sich bekleiden, sich anziehen
gahardjan	verhärten, verstocken
gahaunjan	erniedrigen
gahauseins	Gehör, Predigt
gahausjan	hören, vernehmen, das Gehör bekommen
gahilpan	helfen
gahlaiba	Genosse, Amtsgenosse
gahlaifs	Genosse
gahnaiwjan	erniedrigen
gahnipnan	sich betrüben
gahōbains	Enthaltsamkeit
gahōban	sich enthalten
gahōrinōn	Ehebruch begehen
gahraineins	Reinigung
gahrainjan	reinigen
gahts	Gang
gāhts	gangbar
gahugds	Gesinnung, Sinn, Gewissen
gahugjan	meinen
gahuljan	verhüllen, verbergen
gaƕaírban	umdrehen, umkehren, bekehren
gaƕaírbs	fügsam, getreu, gehorsam
gaƕatjan	anreizen, verlocken
gaƕeilains	Verweilen, Ruhe
gaƕeilan	zur Ruhe kommen, aufhören, verweilen
gaƕeitjan	weißen, weiß machen
gaƕōtjan	bedrohen, schelten, strafen
gaíaínna	Hölle
gaibnjan	gleichmachen, ebnen
gaida	Speerspitze
gaidreigōn	bereuen, Buße tun, sich ändern
gaidw	Mangel
gailjan	fröhlich machen, erfreuen
gails	Speer
gails	froh, fröhlich, üppig
gain	Waffe
gainōn	gähnen
gaírda	Gürtel, Gurt
gairdan	gürten
gaírnei	Verlangen, Wunsch, Begehren
gairnjan	begehren, verlangen, bedürfen
gaírns	begierig, gierig
gaíruni	Leidenschaft
gais	Ger, Speer
gaisjan	schrecken
gaitein	Böcklein, Zicklein, junge Ziege
gaiteins	Ziegen
gaits	Ziege
gajiukan	besiegen, überwinden
gajuk	Gespann, Paar
gajuka	Genosse
gajukō	Genossin
gajukō	Zusammenstellung, Zusammenjochung, Gleichnis
gakannjan	verkünden, berichten, bekanntmachen, empfehlen
gakarōn	besorgen, sich kümmern, sorgen für
gakausjan	erproben, prüfen
gakiusan	erproben, wählen, prüfen
gakrōtōn	zerbrechen, zerschellen, zermalmen
gakunds	Überredung
gakunnan	nachgeben, unterordnen, gehorchen
gakunnan	kennenlernen, erfahren
gakunþs	Anfang, Bekanntwerdung
gakusans	bewährt, erprobt, auserwählt
gakusts	Probe, Prüfung
gala	Sänger
galagjan	hinlegen, legen, werfen, auflegen, aufsetzen, liegen
galaisjan	lehren, belehren, lernen
galaista	Nachfolger, Verfolger, Begleiter
galaistjan	nachfolgen, befolgen, pflegen
galan	rufen, singen
galatjan	aufhalten, verhindern, verzögern
galaþōn	zusammenberufen, einladen
galaubei	Glanz, Kostbarkeit, Pracht
galaubeins	Glaube
galaubeins	gläubig
galaubjan	glauben, anvertrauen
galaufs	wertvoll, kostbar, teuer
galaugnjan	verbergen, verborgen bleiben
galausjan	erlösen, befreien, losmachen, loslassen, bewahren, behüten, eintreiben
gald	unfruchtbarer Boden
galeika	Miteinverleibter, eines Leibes
galeikan	gefallen
galeiki	Ähnlichkeit, Abbild
galeikō	ähnlich, gleich
galeikōn	vergleichen, gleichen, nachahmen
galeiks	ähnlich, gleich
galeiþan	kommen, gehen, fahren
galēkinōn	herstellen, heilen
galēwjan	hingeben, überlassen
galēwjands	Verräter
galga	Pfahl, Kreuz
galigri	Beilager, Beischlaf
galisan	zusammenlesen, versammeln, sammeln
galiug	Lüge, Götzenbild
galiugaapaústaúlus	Lügenapostel, falscher Apostel
galiugabrōþar	Lügenbruder, falscher Bruder
galiugaguþ	Lügengott, Götze, falscher Gott
galiugan	ein Weib nehmen, heiraten
galiugan	belügen, lügen
galiugapraúfētus	Lügenprophet, falscher Prophet
galiugaweitwōþs	Lügenzeuge, falscher Zeuge
galiugaxristus	Lügenchristus, falscher Christus
galiuhtjan	erleuchten, ans Licht bringen
galþeis	unfruchtbar
galūkan	verschließen, fangen, zuschließen, schließen
galuknan	sich verschließen, verschlossen werden
gamagan	gelten, bedeuten, vermögen
gamaindūþs	Gemeinschaft
gamainei	Gemeinschaft
gamainja	Teilnehmer
gamainjan	gemein machen, Gemeinschaft halten, mitteilen, Anteil haben, sich beteiligen, verunreinigen, entheiligen
gamains	gemein, gemeinsam, gemeinschaftlich, teilhaftig, unheilig
gamainþs	Versammlung
gamaitan	zerschneiden, verschneiden
gamaiþs	verkrüppelt, verwundet
gamalteins	Auflösung
gamaltjan	auflösen, schmelzen
gamalwjan	zermalmen, zerknirschen
gaman	Mitmensch, Teilnehmer, Genosse, Gemeinschaft, Genossenschaft
gamanwjan	zubereiten, bereiten
gamarka	benachbart, angrenzend
gamarkō	Grenznachbarin
gamarkōn	grenzen an
gamarzeins	Ärgernis
gamarzjan	ärgern, Ärgernis erregen, Ärgernis nehmen
gamatjan	essen
gamaudeins	Erinnerung
gamaudjan	erinnern
gamaúrgjan	verkürzen, abkürzen, kürzen
gamēleins	Schrift, Buchstabenschrift
gamēliþsbzw.þatagamēlidō)	Geschriebenes, Schrift
gamēljan	schreiben, aufschreiben, sich in die Listen eintragen lassen
gamikiljan	groß machen, preisen, erheben
gaminþi	Erinnerung, Gedächtnis
gamitan	zumessen, zuteilen
gamitōn	denken, überlegen
gamitōns	Gedanke
gamiþsandjan	mitsenden
gamōtan	Raum finden, Erlaubnis haben, dürfen
gamōtjan	begegnen
gamunan	sich erinnern, gedenken
gamunds	Andenken, Gedächtnis
ganagljan	festnageln, annageln, nageln
ganah	es genügt
ganaitjan	beschimpfen, schmähen, lästern
ganamnjan	benennen, nennen
ganasjan	erretten, herstellen, heilen, retten
ganatjan	benetzen
ganaúha	Genüge, Auskommen, Genügsamkeit
ganaúhan	genügen, zur Genüge versehen sein mit
ganawistrōn	begraben
gands	Stock, Stab, Zauber
ganiman	mitnehmen, erhalten, erben, davontragen, vergolten bekommen, empfangen, lernen, aufnehmen
ganisan	genesen, gerettet werden, selig werden
ganists	Rettung, Heil, Erhaltung
ganiþjis	Verwandter
ganiutan	ergreifen, erwischen, fangen
ganōhjan	gewähren, befriedigen, sich genügen lassen
ganōhnan	zur Genüge versehen sein
ganōhs	genug, viel
ganōn	gähnen
gans	Gans
gansjan	verursachen
ganta	Wildgans
gapaidōn	bekleiden
gaqiman	zusammenkommen, hinkommen, kommen, sich versammeln
gaqiss	übereinstimmend
gaqiss	Verabredung
gaqiþan	sich verabreden, übereinkommen, beschließen, besprechen
gaqiujan	beleben, lebendig machen
gaqiunan	aufleben, lebendig werden
gaqumþs	Zusammenkunft, Versammlung, Vereinigung
garaginōn	Rat geben, raten
garahnjan	abschätzen
garaideins	Anordnung, Satzung, Regel
garaidjan	befehlen, verordnen, bestimmen, anordnen, festsetzen
garaíhtaba	gerecht, mit Recht
garaíhtei	Gerechtigkeit, Gebot
garaíhteins	Zurechtweisung, Wiederherstellung
garaíhtiþa	Gerechtigkeit
garaíhtjan	als gerecht erweisen, etwas richten, hinlenken, lenken, rechtfertigen
garaíhts	gerecht
garaiþs	angeordnet
garaþan	zählen
garaþjan	zählen
garazna	Nachbar
garaznō	Nachbarin
garba	Garbe
garda	Hürde, Viehhof
gardawaldands	Hausherr
gardi	Gehege
gardiggs	Hofmann, Hofbeamter
gardingatus	Hofamt
gardingus	Hofmann, Hofbeamter
gards	Haus, Hauswesen, Familie, Hof, Prätorium
garēdaba	anständig, ehrbar
garēdan	Vorsorge treffen, raten, versorgen
garēhsns	bestimmte Zeit, Bestimmung, Plan
garēþs	anständig
garinnan	zusammenlaufen, zusammenkommen, erlaufen, erringen, erlangen
gariudan	erröten
gariudei	Schamhaftigkeit
gariudi	Ehrbarkeit
gariuþs	ehrbar
gart	Rebe
garūni	Beratung, Beratschlagung
garunjō	Flut, Überschwemmung
garuns	Markt, Straße
garwi	Schmuck
garwōn	bereiten, kleiden
garws	Schmuck
gasahts	Vorwurf, Tadel, Zurechtweisung, Beschuldigung
gasaíƕan	erblicken, sehen,
gasaíƕans	gesehen, sichtbar
gasakan	überführen, schelten, den Mund stopfen, zum Schweigen bringen, widerlegen
gasalbōn	salben, besalben
gasalja	Hausgemeinschaft, Genosse
gasaljan	opfern, zum Opfer bringen
gasandjan	entsenden, geleiten
gasateins	Grundlegung
gasatjan	hinsetzen, hinstellen, hinlegen, beilegen, anordnen, einsetzen, wiederherstellen
gasibjōn	sich versöhnen
gasiggqan	versinken, untergehen
gasigljan	besiegeln, bestätigen, versiegeln
gasinþa	Gefährte, Reisegefährte
gasinþja	Gefährte, Reisegefährte
gasitan	sich niedersetzen, Platz nehmen
gaskadweins	Beschattung, Bedeckung, Bekleidung
gaskadwjan	beschatten, bedecken
gaskafts	Erschaffung, Geschöpf
gaskaidansik	sich zurückziehen, sich trennen
gaskaideins	Unterschied, Trennung, Scheidung
gaskaidnan	geschieden werden, sich scheiden
gaskalki	Mitknecht
gaskamansik	beschämt werden, sich schämen
gaskapjan	erschaffen, schaffen
gaskaþjan	schaden, Schaden zufügen, Unrecht tun
gaskeirjan	erklären, auslegen, übersetzen
gaskōhi	Sandalen, Schuhe, Schuhwerk
gaskōhs	beschuht
gaslawan	schweigen, verstummen
gasleiþjan	beschädigen, schädigen, schaden
gaslēpan	schlafen, entschlafen, einschlafen
gasmeitan	aufstreichen, beschmieren
gasmiþōn	schmieden, bewirken, durch Schmieden bewirken
gasniumjan	hineilen, kommen
gasniwan	ereilen, gelangen zu, erlangen
gasōkjan	aufsuchen, suchen
gasōþjan	ersättigen, sättigen
gaspeiwan	ausspeien, speien
gaspillōn	verkünden
gastagqjan	anstoßen
gastaldan	erwerben, bekommen
gastalds	gewinnsüchtig
gastandan	stehenbleiben, haltmachen, bestehen, verbleiben, beharren, stillstehen, bleiben, verharren, wiederhergestellt sein
gastaúrknan	vertrocknen, verdorren
gasteigan	hineinsteigen, herabsteigen
gastiggqan	anstoßen
gastigōdei	Gastfreundschaft
gastigōþs	gastfrei, gastfreundlich
gastōjan	ein Urteil abgeben über, beurteilen, verurteilen, urteilen, beschließen, richten
gastōþan	aufrecht erhalten
gastōþs	fest
gastraujan	bestreuen, belegen, überdecken, überbreiten
gasts	Fremdling, Fremder, Gast
gasūljan	das Fundament legen, begründen, gründen
gasunjōn	rechtfertigen
gasupōn	würzen, salzen
gaswēran	verherrlichen, verklären
gaswikunþjan	bekanntgeben, offenbaren, sich offenbaren, erscheinen
gaswiltan	sterben, absterben
gaswinþjan	stärken
gaswinþnan	erstarken, stark werden
gaswōgjan	erseufzen, seufzen
gataiknjan	ein Zeichen geben, belehren, zeigen
gataíran	zerreißen, zerstören, aufheben, auflösen
gatalzjan	belehren, erziehen
gatamjan	bezähmen, bezwingen, zähmen, bändigen
gatandjan	brandmarken, mit einem Brandmal versehen
gatarhjan	kennzeichnen, sich merken, auszeichnen
gatarnjan	berauben
gatass	geordnet, geregelt
gataujan	vollbringen, bewirken, machen, tun, wirken, bringen
gataúra	Riss
gataúrnan	vergehen, aufhören, zerreißen
gataúrþs	Zerstörung
gateihan	anzeigen, verkünden, verkündigen
gatēmiba	geziemend
gatēms	geziemend
gatēwiþs	geordnet
gatēwjan	verordnen, bestimmen
gatilaba	zur rechten Zeit, passend
gatilōn	erlangen, erzielen
gatils	passend, geschickt
gatiman	geziemen
gatimreins	Erbauung
gatimrjan	erbauen, bauen
gatimrjō	Gebäude, Bau
gatiuhan	wegziehen, wegführen, führen, bringen
gatráuan	vertrauen, anvertrauen, trauen
gatrudan	zertreten, niedertreten
gatulgjan	befestigen, bestärken
gatwō	Gasse
gaþagki	Bedacht
gaþahan	verstummen, das Schweigen fortsetzen
gaþaírsan	verdorren
gaþarban	sich enthalten
gaþaúrbs	enthaltsam
gaþaúrpan	vergleichen
gaþaúrsnan	verdorren, vertrocknen
gaþeihan	vorwärtskommen, hervorsprießen, wachsen, zunehmen
gaþiuþjan	segnen, den Segen geben
gaþiwan	dienstbar machen, unterjochen, durchbohren
gaþlahsnan	erschrecken
gaþlaihan	ermahnen, trösten, in die Arme schließen, umarmen
gaþlaihts	Trost
gaþliuhan	die Flucht ergreifen, entfliehen, fliehen
gaþrafsteins	Trost
gaþrafstjan	trösten, ermuntern, Trost bringen, Trost empfangen
gaþrask	Tenne, Ausdrusch
gaþreihan	bedrängen
gaþriskan	dreschen
gaþulan	erdulden, dulden
gaþwastjan	befestigen, stärken
gaud	Bedeutung dunkel
gauja	Gaubewohner
gauma	Aufmerksamkeit
gauma	Kropf
gaumjan	bemerken, erscheinen, seine Aufmerksamkeit auf etwas richten
gaunlēdjan	arm machen
gaunōn	klagen, Totenklage anstimmen
gaunōþus	Klage
gaur	Betrübnis
gaurei	Betrübnis
gauriþa	Betrübnis
gaurjan	kränken, betrüben
gaurs	betrübt, traurig, mürrisch
gaus	tönend
Gauti	Goten
Gauts	Gote
gawadjōn	zusammenfügen, verloben
gawagiþs	bewegt, beweglich
gawagjan	in Bewegung setzen, ermuntern, anregen, bewegen, erregen
gawaírpan	hinwerfen, niederwerfen, werfen, hinundherreißen
gawaírþan	sich zuwenden, sich nähern, sich zusammentun
gawaírþeigs	friedfertig, friedlich
gawaírþi	Friede
gawaírþjan	versöhnen
gawaírþnan	versöhnt werden, sich versöhnen
gawaknan	erwachen
gawaldan	sich der Herrschaft bemächtigen, vergewaltigen
gawaleins	Erwählung, Wahl
gawaljan	erwählen, auserwählen, auswählen
gawamms	gemein, unrein, befleckt
gawandeins	Bekehrung
gawandjan	wenden, zurückwenden, hinlenken, bekehren, zurückgeben, hinwenden, umkehren, zurückkehren
gawargeins	Verurteilung, Verdammung, Verdammnis
gawargjan	einen verurteilen zu, ächten, verdammen
gawaseins	Bekleidung, Kleidung
gawasjan	bekleiden, kleiden, sich bekleiden, sich kleiden
gawaúrdi	Gespräch, Rede
gawaúrki	Geschäft, Erwerb, Gewinn
gawaúrkjan	bewirken, erwirken, bereiten, machen, bringen, erhandeln, ausstellen
gawaúrstwa	Mitarbeiter
gawaúrts	eingewurzelt
gaweihan	weihen, heiligen
gaweisōn	besuchen, heimsuchen, besorgen
gawēnjan	erwarten, annehmen, meinen
gawi	Gau, Land, Bezirk, Umgegend, Gegend
gawidan	zusammenbinden, verbinden
gawigan	bewegen, schütteln
gawiljis	einmütig, gewillt
gawindan	sich verwickeln
gawinnan	erleiden, leiden
gawisan	verweilen, verbleiben
gawiss	Verbindung, Gelenk, Band der Gelenke
gawitan	verteidigen
gawizneigs	voll Mitfreude
gawizns	Freude
gawrikan	bestrafen, rächen, Rache nehmen
gawrisqan	Frucht bringen
gawundōn	verwunden
gazaúflakiō)	Schatzhaus, Schatzkammer
gazds	Stachel, Peitsche
geen	gehen
geigan	begehren
geirō	Gier
geirs	gierig
geisls	Geisel
geisnan	erschrecken
giba	Gabe, Geschenk, gRune
giban	geben
gibands	Geber
gibla	Giebel
gijan	gähnen
gild	Steuer, Abgabe, Zins
gildan	gelten
gilstr	Steuer, Abgabe
gilstramēleins	Eintragung in die Steuerliste
gilþa	Sichel
ginnan	beginnen
gisls	Speer
gistradagis	morgen
gitan	finden, bekommen, erlangen
giutan	gießen
glad	froh, fröhlich
glaggwaba	sorgsam
glaggwō	genau
glaggws	genau
glaggwuba	genau
glitmuni	Glanz
glitmunjan	glänzen
glōfa	Handschuh
gōdakunds	von guter Abkunft, edlen Geschlechts
gōdei	Tugend, Tüchtigkeit, Güte
gōleins	Gruß
gōljan	grüßen
gōma	Gaumen
Goti	Goten
Goþiscandza	Gotenende
gōþs	gut, schön, tüchtig
graba	Graben
graban	graben
grama	Gram
gramjan	erzürnen, aufregen
grams	zornig
gramst	Holzsplitter, Splitter
grana	Bart, Barthaar, Zopf
granō	Bart, Barthaar, Zopf
granus	Bart, Barthaar, Zopf
gras	Gras, Kraut
Grautungōs	Greutungen, Ostgoten
grēdags	hungrig
grēdōn	hungern
grēdus	Hunger
grēfan	gebieten, anordnen
grēfts	Beschluss, Verordnung, Befehl
greima	Maske
greipan	greifen, ergreifen
greiseis	greis, grau
Greotingi	Ostgoten
grētan	weinen, klagen
grēts	Weinen
greut	Grieß, Sand
grēws	grau
grimman	ergrimmen, zürnen
grimmiþa	Grimm
grimms	grimmig, zornig, schrecklich
grindafraþjis	kleinmütig
grindan	zerreiben
grinds	zerrieben
gris	Schrecken
griþs	Schritt, Stufe
Griutuggōs	Ostgoten
grōba	Grube, Höhle
grundiþa	Grund
grundus	Grund
grunduwaddjus	Grundmauer
grūts	Grütze
Grūtungi	Ostgoten
gudaba	fromm
gudafaúrhts	gottesfürchtig
gudalaus	gottlos
gudaskaunei	Gottesgestalt
gudblōstreis	Gottesverehrer
gudei	Frömmigkeit
gudhūs	Gotteshaus, Tempel
gudisks	göttlich
gudja	Priester
gudjinassus	Priestertum
gudjinōn	Priester sein, das Priesteramt verrichten
gulþ	Gold
gulþeins	golden
guma	Mann
gumakunds	männlich
gumein	Männchen
gumeins	männlich
gund	Krebsgeschwür, Geschwür
gunþi	Kampf
gunþs	Kampf
Guta	Gote
Gutan	Goten
gutisks	gotisch
gutnan	gegossen werden
Gutō	Gotin
Gutþiuda	Gotenvolk
guþ	Angerufener, Gott, Götze
h	h, Abkürzung für 8
haban	haben, besitzen, inne haben, meinen, halten, werden, sich befinden, können, wollen
habands	habend
hafjan	heben, aufheben
hafnan	sich heben
haftjansik)	 heften, anhängen, anheften
haftnan	angeheftet werden
hafts	behaftet
hagja	Pfleger, Heger
hagka	Hüfte
hagl	Hagel, hRune
hāh	Hängen, Hang
hāhan	hängen, schweben lassen
hāhan	hangen
hāhjis	hängend
Haíbraius	Hebräer
haidus	Art
haifstjan	streiten
haifsts	Streit, Zank
haihs	einäugig
hailags	heilig, geweiht
haili	Heil
hailisks	heil, lebendig
hailjan	heilen
hailnan	geheilt werden
hails	heil, gesund, wohl
hails	sei gegrüßt
haima	Land
haimeis	heimisch
haimōþli	Grundbesitz, Familiengut
haims	Dorf, Land, Flecken
hairaíseis	Parteien, Ketzerei
haírda	Herde
haírdeis	Hirt
haírtō	Herz
haírts	herzig
haírþra	Eingeweide, Herz, Inneres
haírus	Schwert
hais	Fackel
haitan	heißen, nennen, heißen, genannt werden, rufen, einladen, befehlen
haiti	Geheiß, Befehl
haitja	Heißer
haiþi	Heide, Steppe, Feld, Acker
haiþiwisks	wild
haiþnō	Heidin
haiþns	heidnisch
hakiljan	hecheln
hakuls	Mantel
halba	Hälfte, Seite, Teil
halbs	halb
haldan	hüten, weiden, halten
haldis	mehr, lieber
halis	kaum
halisaiw	kaum je, kaum
halja	Hölle
haljōrūna	Hexe, Zauberweib
halks	leer, umsonst, dürftig, armselig
hallus	Fels, Stein
hals	Hals
halsagga	Hals, Nacken
halts	lahm
halþei	Neigung
halþs	geneigt
hamfs	verstümmelt, gekrümmt, lahm
hamōn	kleiden
hams	Hülle
hana	Hahn
handa	Hand
handugei	Weisheit, Klugheit, Geschicklichkeit
handugs	weise, klug, geschickt
handus	Hand
handuwaúrhts	handgemacht, mit der Hand gemacht
hanō	Huhn, Henne
hansa	Schar, Manipel, Kohorte, Menge
harbisjan	abpflücken
harduba	sehr, hart
harduhaírtei	Hartherzigkeit
harduhaírts	hartherzig
hardus	hart, streng
haribaírgō	Herberge
hariggs	Hering
harihriggs	Heerring
harjatuga	Heerführer
harjis	Heer, Menge
harpa	Harfe
harpōn	packen
haspa	Haspe, Winde
haspan	haspeln
hasws	grau
hatan	hassen
hatis	Hass, Zorn
hatizōn	zürnen
hatjan	hassen
haþus	Kampf
haubiþ	Haupt, Kopf
hauhaba	hoch
hauhei	Höhe
hauheins	Erhöhung, Preis, Ehre
hauhhaírtei	Hochmut
hauhhaírts	hochmütig
hauhis	höher
hauhisti	höchste Höhe
hauhiþa	Höhe, Erhebung, Ehre
hauhjan	hoch machen, erhöhen, preisen, verherrlichen
hauhnan	erhöht werden
hauhs	hoch
hauhþūhts	hochmütig, verblendet
hauneins	Erniedrigung, Demut
hauniþa	Demut
haunjan	erniedrigen, niedrig machen
hauns	niedrig, demütig
haúrds	Tür, geflochtene Tür
haúri	Kohle, Kohlenfeuer
haúrn	Horn, Frucht des Johannisbrotbaums, Bockshorn
haúrnja	Hornbläser, Hornist
haúrnjan	hornblasen, das Horn blasen, trompeten
hauseins	Gehör, Ohr, das Gehörte, Hören, Predigt, Gehorsam
hausjan	hören, anhören, zuhören
hausjōn	hören
hawi	Heu
hazds	Haar
hazdwalds	Haarwalter, Heerwalter
hazeins	Lob, Loblied, Lobgesang, Preis
hazer	tausend
hazjan	loben, preisen
heitō	Hitze, Fieber
heits	heiß
heiwa	Hausstand
heiwafrauja	Hausherr
heiwiski	Familie, Haushalt
hēlei	eli, mein Gott
hēr	hier, her
hēþjō	Kammer
hi	dieser
hidrē	hierher
hildi	Kampf
hilds	Kampf
hilms	Helm
hilpan	helfen
himinakunds	von himmlischer Abkunft, himmlisch
himins	Himmel
hindana	hinter, jenseits
hindar	hinter, jenseits, über
hindarleiþan	hinzukommen, vergehen
hindarweis	hinterlistig, verstellt
hindarweisei	Hinterlist
hindumists	hinterste, letzte, äußerste
hinþan	fangen
hiri	hierher, komm her
hirjan	kommen
his	er, dieser
hiufan	wehklagen, Klagelieder singen
hiuhma	Haufen, Menge
hiwi	Gestalt, Aussehen
hlahjan	lachen
hlaifs	Brot, Brotlaib, Brotbissen, Bissen
hlain	Hügel
hlaiw	Grab
hlaiwasnōs	Gräber
hlamma	Falle, Schlinge
hlas	heiter, fröhlich, sorgenfrei
hlasei	Fröhlichkeit, Heiterkeit
hlaþan	laden
hlaupan	laufen, springen
hlauts	Los, Anteil, Erbschaft
hleibjan	sich annehmen
hleiduma	link
hleiþra	Zelt, Hütte
hleþrastakeins	Zeltabsteckung, Zeltaufschlagen, Laubhüttenfest
hlifan	stehlen
hliftus	Dieb
hlija	Hütte, Zelt
hlimman	rauschen
hliuma	Gehör, Ohren
hliutan	losen
hliuþ	Gehör, Schweigen, Stille, Aufmerksamkeit
hlōhjan	lachen machen
hlūtrei	Lauterkeit, Reinheit, Aufrichtigkeit
hlūtriþa	Lauterkeit, Reinheit, Aufrichtigkeit
hlūtrs	lauter, rein
hluþ	berühmt
hnaiweins	Erniedrigung, Demut
hnaiwjan	niedrig machen, erniedrigen
hnaiws	niedrig, demütig
hnapps	Napf
hnasqus	weich, weichlich, zart
hneipan	betrüben
hneiwan	sich neigen
hnipnan	sich betrüben, trauern
hniupan	reißen
hnupnan	zerreißen, zerrissen werden
hnuþō	spitzer Pfahl
hōban	halten, passen
hōha	Pflug
hoka	Geiß
hōl	Betrug
hōlōn	verleumden, betrügen, durch Betrug schädigen, schikanieren, schaden
hōrinassus	Ehebruch, Hurerei
hōrinōn	huren, die Ehe brechen, Ehebruch treiben
hōrs	Hurer, Ehebrecher
hrabns	Rabe
hrainei	Reinheit, Reinigung
hraineins	Reinigung
hrainiþa	Reinheit
hrainjahaírts	reinherzig, reinen Herzens seiend
hrainjan	reinigen
hrains	rein, ehrbar
hraiw	Leiche
hraiwadūbō	Leichentaube, Turteltaube
hrama	Gestell
hramjan	kreuzigen
hranka	Ranke
hrankjan	ranken
hrapōn	stürzen, eilen
hriggs	Ring, Kreis
hrisjan	schütteln
hrōms	Ruhm
hrōpan	rufen
hrōpjan	rufen, schreien
hrōps	Ruf, Geschrei
hrōt	Dach, Haus
hrōþ	Ruhm, Sieg
hrōþeigs	ruhmreich, siegreich
hrugga	Stab, Rute
hrūk	Krähen
hrūkjan	krähen
hrunkjan	runzeln
hruskan	forschen
hugds	Gesinnung
huggrjan	hungern
hugjan	denken, meinen, glauben
hugs	Verstand, Sinn
hugs	Landgut, Feld
hūhjan	häufen, sammeln
hūhrus	Hunger, Hungersnot
huleins	Hüllung
hulistr	Hülle, Decke
huljan	hüllen, verhüllen
Hulmarugeis	Rugier
hulms	Insel
hulōn	höhlen
huls	hohl
hulþa	Holder
hulþō	Holde
hulþs	hold, gnädig, günstig
hulundi	Höhle
hund	hundert
hundafaþs	Zenturio, Hundertführer
hunds	Hund
hūns	junger Bär
hunsl	Opfer
hunslags	versöhnlich
hunslastaþs	Opferstätte, Altar
hunsljan	opfern
hunþs	Fang, Beute
hups	Hüfte
hūs	Haus
husa	Beinschiene, Hose, Beinkleid
huzd	Hort, Schatz
huzdjan	Schätze sammeln, sammeln
hwssōpō	Ysop
ƕadrē	wohin
ƕair	Kessel, ƕRune
ƕaírban	wandeln, sich wenden
ƕaírnei	Schädel
ƕaírneins	Schädel
ƕaírnō	Schädel
ƕaiteis	Weizen
ƕaiwa	wie, irgendwie
ƕan	wann, irgendwann, wie, um wieviel, etwa
ƕanhun	jemals
ƕapjan	ersticken
ƕapnan	ersticken
ƕar	wo
ƕarbōn	wandeln, gehen, umhergehen
ƕarjis	welcher, wer
ƕarjizuh	jeder
ƕas	wer, was, irgendeiner, jemand, etwas
ƕashun	jemand
ƕassaba	scharf, streng
ƕassei	Strenge, Schärfe
ƕatjan	anreizen, verlocken
ƕats	scharf
ƕaþ	wohin
ƕaþar	wer von beiden
ƕaþaruh	jeder von beiden
ƕaþjan	schäumen
ƕaþō	Schaum
ƕaþrō	woher, von woher
ƕazuh	jeder
ƕē	wem, mit wem, womit, um was, irgendwie, etwa
ƕēh	jedenfalls, nur
ƕeila	Weile, Zeit, Stunde
ƕeilaƕaírbs	nur eine Zeitlang dauernd, vergänglich, unbeständig
ƕeilains	Ruhe, Verweilen
ƕeilan	aufhören
ƕeilōhun	eine Stunde lang
ƕeitags	weiß
ƕeitjan	weißen
ƕeits	weiß
ƕēlauþs	wie groß
ƕilban	wölben
ƕileiks	wie beschaffen, was für ein, welcher
ƕilftri	Wölbung
ƕilftrjōs	Totenkiste, Sarg
ƕj	760
ƕke	725
ƕm	740
ƕmg	743
ƕōftuli	Ruhm, Rühmen
ƕōpan	sich rühmen
ƕōta	Drohung
ƕōtjan	drohen
ƕssōpō	Ysop
ƕz	707
i	i, Abkürzung für 10
ia	11
ib	12
ibai	ob, etwa, wohl, ob denn, doch wohl, doch nicht, dass nicht etwa
ibdalja	Berglehne, Abhang
ibna	gleich
ibnaleiks	gleichen Körpers, gleich
ibnaskauns	gleichschön, gleichgesichtig, gleichgestaltet
ibnassus	Gleichheit, Billigkeit
ibnatjan	gleichmachen, ebnen
ibnjan	ebnen
ibnōn	ebnen
ibns	eben, flach, gleich
ibrs	Eber
ibuks	rückwärts gewandt, zurück
id	14
iddja	ging
idreiga	Buße
idreigōn	bereuen, Buße tun
idreigs	reuig
idweit	Schmach, Schimpf
idweitan	rügen, zurechtweisen
idweitjan	schmähen
ie	15
iftuma	folgende
ig	13
igils	Igel
igqar	euch beiden gehörig, euer beider
ih	18
iiz	Eis, iRune
ik	ich
ikei	der ich, ich welcher
in	in, an, auf, unter, zu, während, bei, über, nach, gegen, um, für, bis zu, wegen, um willen, durch
inagjan	anfahren, bedrohen, in Angst setzen
inahei	Besonnenheit, Selbstbeherrschung
inahs	verständig, besonnen, klug
inaljanōn	zornig machen, reizen
inbrannjan	anbrennen, in Brand stecken
indrōbnan	in Bestürzung geraten, erschüttert werden
infeinan	sich erbarmen, gerührt sein
ingaleikōn	verwandeln, umwandeln
ingardja	Hausgenosse
ingardja	im Haus befindlich
ingif	Gift
ingramjan	erbittern
ingrimjis	schrecklich
inilō	Entschuldigung, Vorwand, Gelegenheit
inilōn	einwenden
inkilþō	schwanger, Schwangere
inkunja	Stammesgenosse, Landsmann
inliuhtjan	erleuchten
inmaideins	Vertauschung, Tausch
inmaidjan	verwandeln, verändern
inn	hinein
inna	innen, innerhalb
innakunds	zum Haus gehörig, Hausgenosse
innana	von innen, hinein, innen, innerhalb, inwendig
innatbaíran	hineinbringen, hineintragen
innatgaggan	hineingehen, hineinkommen
innatgāhts	Eingang, Eintritt
innattiuhan	hineinziehen, hineinführen
innaþrō	von innen, inwendig
inngaggan	hineingehen, fortgehen
inngaleiþan	hineingehen
inniman	hernehmen
inniujiþa	Erneuerung, Fest der Tempelweihe, Kirchweihe
innufsliupan	weiter hinaufschlüpfen, hineinschlüpfen
innuma	der innere, innerlich
innwaírpan	hineinwerfen
inraúhtjan	erzürnt werden, zürnen, unwillig sein
inreiran	erzittern, erbeben
ins	Schwert
insahts	Erzählung, Aussage, Zeugnis
insáian	einsäen, hineinsäen
insaíƕan	hinsehen, ansehen, auf etwas sehen, nach etwas sehen, aufblicken, sich umsehen
insailjan	anseilen, herablassen
insakan	vorstellen, anraten, eintreten für, bezeichnen, vortragen, anzeigen
insandjan	entsenden, hinsenden, zusenden, senden
instandan	bevorstehen, eintreten für
inswinþjan	stärken
intandjan	anzünden, verbrennen, in Brand setzen
intrusgjan	einpfropfen
intundnan	verbrennen
inuh	ohne, außer
inwagjan	erregen, aufwiegeln
inwandjan	hineinwenden, verdrehen, verkehren
inweitan	Verehrung erweisen, begrüßen, anbeten, ansehen, verehren
inweitjan	anbeten, behexen
inwidan	verleugnen, für ungültig erklären
inwindiþa	Ungerechtigkeit
inwinds	gewunden, ungerecht, verkehrt, verdorben
inwisan)	bevorstehen
inwitōþs	innerhalb des Gesetzes stehend, gesetzlich
iowi	ein Gott
iq	16
is	er
isks	isch
Israēl	Israel
Israēleitēs	Israelit
itan	essen
iþ	aber, und, wenn, nun, also, denn
iþ	19
Iudaialand	Judäa
Iudaius	Jude
iudaiwiskō	auf jüdische Weise
iudaiwiskōn	jüdisch leben
iudaiwisks	jüdisch
iumjō	Haufen, Menge
iup	aufwärts, hinauf
iupa	oben, hinauf
iupana	von oben, von Anfang an, von vorne
iupaþrō	von oben
ius	besser
iusila	Erholung, Besserung
iusilōn	bessern, erleichtern
iusiza	besser, vorzüglicher
iuþa	Nachkomme
iz	17
izei	der, welcher
izwar	euer
j	j, Abkürzung für 60
ja	ja
jabai	ob, wenn, wenn nur
jah	und, und zwar, auch, aber, denn
jai	ja, wahrlich, für wahr
jainar	an jenem Ort, dort
jaind	dorthin
jaindrē	dorthin
jaindwaírþs	dorthin gewandt
jains	jener
jainþrō	dorther, von dort
jaþþē	und wenn, sei es dass, gleichviel ob, entweder ... oder
jau	ob
jēr	Jahr, Zeit, jRune
Jesus	Jesus
jiuka	Zornausbruch, Streit
jiukan	kämpfen, ringen, obsiegen
Jiula	Julfest
jiuleis	Julmonat, Dezember
jōta	Jota, Pünktchen
jq	66
ju	schon, doch, nun, jetzt
jūdaiwisks	jüdisch
juggalauþs	Jüngling
juggs	jung, jugendlich
juk	Gespann, Joch, Paar
jukuzi	Joch
junda	Jugend
jūs	ihr
jut	ihr beide
juþan	schon
jūzei	ihr welche, die ihr
k	k, Abkürzung für 20
ka	21
kaìtàloipá	und so weiter
kaisar	Kaiser
kaisaragild	Kaisergeld, Zensus, Steuer, Kaisersteuer
kalb	Kalb
kalbō	junge Kuh, weibliches Kalb, Kalbe
kaldiggs	Quelle, Brunnen
kalds	kalt
kalkinassus	Hurerei, Unzucht
kalkinōn	Unzucht treiben, huren
kalkjō	Hure
kanna	Geschlecht, Nachkommenschaft
kannjan	kund tun, bekanntmachen, empfehlen, verkünden
kapillōn	das Haar abschneiden, scheren
kappōn	hauen, schneiden
kara	Sorge
karja	besorgt
karkara	Kerker, Gefängnis
karōn	sich kümmern
karpa	Karpfen
kart	Wagen
kas	Gefäß
kasja	Töpfer
katils	Kessel
kaup	Handel, Kauf
kaupatjan	ohrfeigen, Faustschlag geben
kaupōn	Geschäfte machen, Handel treiben
kaúrban	Gabe, fromme Stiftung, Opfer
kaúrbaúnas	Tempelschatz
kaúrei	Schwere, Fülle, Last
kaúreins	Schwere, Beschwerlichkeit
kaúriþa	Last, Schwere
kaúrjan	drücken, belästigen, beschweren
kaúrn	Korn, Getreide, Weizen
kaúrnō	Korn
kaúrus	schwer, lästig
kausjan	kosten, kennen lernen, prüfen
kawtsjō	Sicherheit, Bürgschaft, Verschreibung
kb	22
kd	24
ke	25
keinan	keimen
kēlikn	Turm, Speisesaal im Obergeschoß, Söller
kg	23
kh	28
kilan	schlucken, schlingen
kilemschkop	trinke den Becher aus
kilþ	Kind
kilþei	Mutterleib
kind	Kind
kindins	Statthalter, Landpfleger
kinds	Kind, Geschlecht, Art
kinnus	Wange
kintus	Heller
kiusan	prüfen, wählen
klismjan	gellen, klingen, schallen
klismō	Becken, Zimbel, Klingel, Schelle
kluba	Kloben, Kluppe, gespaltener Zweig
knawana	gut
kniu	Knie
knōþs	Geschlecht
knussjan	niederfallen, auf die Knie fallen, knien
knussus	Knien
knutjan	knien
kōka	Kuchen
kōni	kühn
kop	Becher
kq	26
kramjan	drücken
krampa	Klammer, Haken
krappa	Haken
krattōn	kratzen
kreitan	kreischen, schreien
kreitus	Kreis
Krēks	Grieche
kripja	Krippe
kriustan	knirschen
krōtōn	zermalmen
krūka	Krug
krukkja	Krücke
kruppa	runde Masse
krūska	Kleie
krūski	Kleie
krusts	Knirschen
kþ	29
kubitus	Liegen am Tisch, Tischgesellschaft, Gruppe, Tischgenossenschaft
kukjan	küssen
kumei	steh auf
kunawida	Fessel, Band
kundjan	sich vermehren
kunds	stammend
kuni	Geschlecht, Stamm
kunnains	Kennenlernen
kunnan	kennen, wissen
kunnan	kennenlernen
kuns	stammend
kunþi	Kunde, Kenntnis
kunþjan	künden
kunþs	kund, bekannt, Bekannter
kuskeis	keusch
kusma	Kehle, kRune, Geschwür
kusts	Probe
kustus	Prüfung, Beweis
Kwreinaius	kyrenisch, Einwohner von Kyrene
kz	27
l	1, Abkürzung für dreißig
laggamōdei	Langmut
laggamōþs	langmütig
laggei	Länge
laggs	lang
lagjan	legen, auflegen, hinlegen, setzen, stellen
lagus	See, lRune
láian)	schmähen
laiba	Überbleibsel, Rest
laibjan	übrig lassen
laidjan	gehen machen, leiten
laif	Rest
laigaiōn	Legion
laigōn	lecken
laikan	hüpfen, springen
laiks	Tanz
laíktjō	Leseabschnitt, Lektion
laisan	wissen, erfahren
laisāreis	Lehrer
laiseigs	zum Lehren befähigt, zum Lehren geeignet, lehrend
laiseins	Lehre
laisiþs	gelehrt
laisjan	lehren, belehren, sich belehren
laisō	Lehre
laistjan	folgen, nachstreben, verfolgen, nachgehen
laistōn	leisten
laists	Spur
laiþs	leid
Laiwweitus	Levit
lamb	Lamm, Schaf, junges Kleinvieh
lameis	lahm, schlaff, mild, matt
land	Land, Landgut, Gegend
landjō	Lende
lapins	Löffel
lasiws	schwach
laska	Fetzen
latei	Lässigkeit, Trägheit
latjan	aufhalten, verzögern, lange dauern
lats	lässig, träge, faul
laþa	Ruf, Ladung
laþaleikō	gern
laþaleiks	gern
laþōn	einladen
laþōns	Einladung, Berufung, Trost, Erlösung
laubei	Glanz
laubja	Laubhütte
laubjan	erlauben
laubjōlaubi	Laube, Vorhalle, Dach
laudi	Gestalt
laufs	Laub, Blatt
laufs	wertvoll
laugnjan	leugnen
laugns	Verborgenheit
lauhatjan	blitzen
lauhmuni	Blitz
laun	Lohn, Belohnung, Dank
launawargs	undankbar
launi)	Lohn
laus	los, leer
lausawaúrdei	leeres Gerede, leeres Geschwätz
lausawaúrdi	leeres Gerede, leeres Geschwätz
lausawaúrds	leeres Geschwätz vollführend, hohler Schwätzer
lauseins	Lösung
laushandja	mit leeren Händen
laushandus	mit leeren Händen
lausjan	lösen, losmachen, retten, Geld erheben, Geld eintreiben, Geld zurückfordern, fordern, sich bezahlen lassen
lausqiþrei	Fasten
lausqiþrs	leeren Magens, nüchtern, ungespeist
lauþs	beschaffen, groß
leihts	leicht, leichtsinnig
leiƕansis)	leihen, borgen
leik	Körper, Leib, Leichnam, Fleisch
leikains	Gefallen, Gutdünken, Wohlgefallen, Vorsatz
leikan	gefallen
leikei	Gleichheit
leikeins	leiblich, fleischlich
lein	Leinen, Leinwand, Linnen
leis	kundig
leisei	Kunde
leista	Leiste
leitils	klein, wenig
leiþan	gehen
leiþu	Obstwein
lēkeis	Arzt
lēkinassus	Heilung
lēkinōn	heilen
leodes	Leute
lēt	Lassen
lētan	lassen, zurücklassen, zulassen
lētnan	gelassen werden
lēts	Gelassener
leuba	Liebe
leuda	Leute
leudis	Mann
lēw	Gelegenheit, Veranlassung, Anlass
lēwjan	verraten
libains	Leben
liban	leben
lif	Rest, Überbleibsel
lifnan	übrigbleiben
lifs	Leben, Leib
ligan	liegen, darniederliegen
ligrs	Lager, Bett, Beilager
lima	warum
lind	lind, mild
linda	Linde, Lindenschild
līs	leise, sanft
lisan	sammeln, lesen
liska	Schnitte
lista	zu wenig
listeigs	listig
lists	List
lita	Verstellung, Heuchelei
liteins	Bittgebet, Fürbitte
litjan	heucheln, sich verstellen
liþus	Glied
liubaleiks	lieblich
liudan	wachsen
liufs	lieb, geliebt
liug	Lüge
liuga	Heirat, Ehe
liugaiþs	verheiratet
liugan	heiraten
liugan	lügen, belügen
liugands	lügnerisch
liugn	Lüge
liugnapraufētus	Lügenprophet, falscher Prophet
liugnawaúrds	Lügen redend, lügnerisch
liugnja	Lügner
liuhadei	Erleuchtung, Licht
liuhadeins	Helle, Glanz
liuhadeins	hell
liuhaþ	Licht
liuhtjan	leuchten
liuhts	licht, strahlend, hell
liusan	lösen, los sein
liuta	Heuchler
liutei	Heuchelei, Betrug, Würfelspiel, Trugspiel
liuts	heuchlerisch, betrügerisch
liuþ	Lied
liuþāreis	Sänger
liuþōn	lobsingen, singen
liuþs	Mann, Leute
liwa	Löwe
lōfa	flache Hand
lōna	Lache
lōþr	Luder, Lockspeise
lubains	Hoffnung
luban	hoffen
lubi	Gift
lubjaleis	giftkundig, Zauberer
lubjaleisei	Giftmischerei, Zauberei, Giftkunde
lubō	Liebe
ludja	Angesicht, Antlitz
lufeis	schlaff, einfach
luftus	Luft
luk	Loch, Öffnung
lūkan	schließen
lukarn	Leuchte, Licht
lukarnastaþa	Leuchter
lūknan	sich schließen
luneins	Lösung
lunjan	lösen
luns	Lösegeld
lusnan	gelöst werden
lustōn	begehren, gelüsten
lusts	Lösung
lustus	Lust, Begierde, Verlangen
lustusama	ersehnt
lutōn	täuschen, betrügen, Verführer
m	m, Abkürzung für 40
magan	können, vermögen
magaþei	Jungfräulichkeit
magaþs	Jungfrau, Magd
magula	Knäblein, Knabe
magus	Knabe, Jüngling, Sohn, Knecht
mahteigs	mächtig, möglich, stark, Herrscher
mahts	Macht, Kraft, Vermögen, Wundertat
maideins	Tausch
maidjan	tauschen, verfälschen, Schacher treiben
maíhstus	Mist, Dünger
mail	Runzel
maímbrana	Pergament
mains	gemein, gemeinsam
mais	mehr, vielmehr
maist	höchstens
maists	meiste, größte, höchste
mait	Schneiden
maitan	schneiden, hauen
maiþms	Gabe, Geschenk
maiþs	verkrüppelt, verwundet
maiza	größere
maizō	mehr
mala	stark
malan	mahlen
malma	Sand
malō	Motte
malsks	töricht
malteins	Auflösung
maltjan	auflösen
malwjan	malmen
mammō	Fleisch
mammōna	Mammon, Reichtum
man	Mensch
managdūþs	Menge, Überfluss
managei	Menge, Volk
managfalþs	mannigfaltig
managjan	mehren, vermehren
managnan	reichlich vorhanden sein, Überfluss haben
manags	manch, viel, über
manamaúrþrja	Menschenmörder
manariggws	gezähmt
manasēþs	Menschensaat, Welt, Menschheit
manauli	Gestalt
manleika	Bild
manna	Mensch, Mann, mRune
manna	Manna
mannahun	jemand
manniskōdus	Menschlichkeit
mannisks	menschlich
manwiþa	Bereitschaft, Mittel
manwjan	bereiten, zurechtmachen
manwuba	bereit
manwus	bereit
mar	Meer
maranaþa	der Herr kommt
marei	Meer
marhs	Pferd
marhskalks	Pferdeknecht
marikreitus	Perle
marisaiws	Meersee, See
marka	Mark, Grenze
marka	Zeichen
markōn	bezeichnen
martwr	Märtyrer
marþus	Marder
marþus	Hochzeit
marzeins	Ärgernis
marzjan	ärgern, zum Ärgernis sein
masts	Mast
matibalgs	Ranzen, Speisesack, Speisetasche
matjan	essen, fressen
mats	Speise, Proviant, Mahl
maþa	Wurm, Made
maþa	gut
maþl	Versammlungsort, Marktplatz, Markt
maþlei	Rede, Redeweise
maþleis	Redner
maþljan	reden
maudjan	erinnern
mauiþs	ermüdet
maukō	Bauch
maur	Mohren...
maúrgins	Morgen
maúrgjan	kürzen
maúrgus	kurz
maúrnan	sorgen für, besorgt sein
maúrþr	Mord
maúrþrja	Mörder
maúrþrjan	morden
mawi	Mädchen, Jungfrau
mawilō	Mädchen, Jungfrau
me	45
mēgs	Eidam, Schwiegersohn
meins	mein
mēki	Schwert
mēl	Zeit, Stunde
mēl	Schrift, Mal, Zeichen, Schriftzeichen
mēla	Scheffel, Maß
mēleins	Schrift
mēli	Schrift
mēljan	schreiben, aufschreiben
mēna	Mond
mēnōþs	Monat
mēra	groß
mērei	Kunde, Ruf
mēreins	Verkündigung, Predigt
mēreis	groß, berühmt
mēriþa	Gerücht, Kunde
mērjan	künden, kund tun, verkünden, das Evangelium verkünden
mērjands	Verkündiger, Prediger, Herold
mērnan	bekannt werden
mēs	Tisch, Schüssel, Platte
mēt	Maß
midgardiwaddjus	Zwischenwand
midjasweipains	Überflutung, Sintflut, Überschwemmung
midjis	mittlere, mitten
midjungards	die bewohnte Erde, Erdkreis
miduma	Mitte
midumōn	vermitteln
midumōnds	Mittler
midus	Met
mikilaba	sehr, groß
mikildūþs	Größe
mikilei	Größe
mikiljan	preisen
mikilnan	verherrlicht werden
mikils	groß, stark, viel
mikilþūhts	hochmütig
mildeis	mild, freundlich
mildiþa	Milde, Herz, Mitleid
milhma	Wolke
militōn	Kriegsdienste tun
miliþ	Honig
miltan	schmelzen, sich auflösen
milti	Milz
miluks	Milch
mimz	Fleisch
minds	Denken
minnists	kleinste, geringste, mindeste
minniza	kleiner, geringer
mins	minder, weniger, geringer
minznan	abnehmen, sich mindern
missa	miss, verschieden
missadēþs	Missetat, Sünde
missaleiks	verschieden, mannigfaltig
missaquiss	Zwiespalt, Missrede, Streit
missataujan	missetun
missō	einander, wechselseitig
mitadjō	Maß
mitan	messen
mitaþs	Maß
mitōn	ermessen, bedenken, überlegen
mitōns	Überlegung, Gedanke
miþ	mit, bei, unter
miþanakumbjan	sich mit zu Tische legen, lagern
miþarbaidjan	mitarbeiten, leiden mit
miþfaginōn	sich mitfreuen
miþfrahinþan	mitgefangennehmen
miþgadauþnan	mitsterben
miþgaggan	mitgehen
miþgaleikōn	mitnachahmen
miþganawistrōn	mitbegraben
miþgaqiujan	mitbeleben
miþgasatjan	sich mithinsetzen, sich zusammensetzen
miþgaswiltan	mitsterben
miþgatimrjan	miterbauen
miþgatiuhan	mitfortziehen, mitführen
miþgawisan	zusammenverweilen, zusammen sein
miþinngaleiþan	mithineingehen
miþinsandjan	mitentsenden
miþkaúrjan	mitbelasten
miþliban	mitleben
miþlitjan	mitheucheln
miþmatjan	mitessen
miþniman	annehmen, gelten lassen
miþqiman	mitkommen
miþqiþan	mitsprechen, nachsprechen
miþrōdjan	mit jemandem reden
miþsandjan	senden
miþsatjan	versetzen
miþskalkinōn	Mitknecht sein, mitdienen
miþsōkjan	mitdisputieren, mit jemandem streiten
miþstandan	zusammenstehen mit
miþþan	inzwischen
miþþanei	während
miþþiudanōn	mitherrschen
miþurraisjan	mitaufrichten
miþurreisan	mitaufstehen
miþushramjan	mit jemandem kreuzigen
miþuskeinan	mitauskeimen, mithervorkeimen
miþweitwōdjan	mitbezeugen
miþwisan	beistehen, zu Hilfe kommen
miþwiss	bewusst
miþwissei	Mitwissen, Bewusstsein, Gewissen
miþwitan	bewusst sein
mizdō	Lohn
mōdags	zornig
mōjan	ermüden
mōta	Maut, Zoll, Zollhaus
mōtan	Raum finden, Erlaubnis haben, dürfen
mōtāreis	Zöllner
mōtastaþs	Mautstätte, Zollstätte, Zollhaus
mōtjan	begegnen
mōþs	Zorn, Mut
mōþs	mütig
mudw	Moder
mudweins	schimmelig, verdrießlich
mugan	schimmeln
muirjō	Ameise
mūkamōdei	Nachgiebigkeit, Sanftmut
mūkamōþs	sanftmütig
mūks	sanft, weich
mūlā	Maul
mulda	Staub
muldeins	von Staub, irdisch
mulma	Schlamm
mūlus	Maulwurf
munan	meinen, glauben, dafür halten
munan	zu tun gedenken, wollen
munda	Schutz
mundōn	sich einen besehen, sehen auf
mundrei	Ziel
mundrs	eifrig, zielstrebig
munds	Schutz
munds	Andenken, Gedächtnis
munnōn	denken, gedenken
muns	Gedanke, Meinung, Vorsatz, Ratschluss, Bereitwilligkeit, guter Wille, Beschluss, Entscheidung, Vorsorge, Absicht
munþs	Mund
mūs	Maus
mūstriggs	Fledermaus
n	n, Abkürzung für 50
nadrs	Natter
nagljan	nageln
nagls	Nagel
nah	es ist erlaubt
nahtamats	Abendessen, Abendmahl, Gastmahl, Nachtmahl
nahts	Nacht
naiteins	Lästerung
naitjan	lästern
namnjan	nennen
namō	Name
nanþ	Kühnheit
nanþjan	wagen
nanþs	kühn
naqadei	Nacktheit
naqaþs	nackt
nardus	Narde
naseins	Rettung, Heil
nasjan	retten
nasjands	Heiland, Retter
nastilō	Nestel
nati	Netz, kreisrundes Wurfnetz
natjan	netzen, benetzen
nats	nass
nauan	reiben
naubaimbair	November
naudibandi	Kette
naudiþaúrfts	notwendig
naudiþaúrfts	Notwendigkeit
naúh	noch
naúha	Genügsamkeit, Auskommen
naúhan	dürfen, erlaubt sein
naúhþan	noch
naúhþanuh	noch
naúhuþþan	und sogar noch
naúrþs	nördlich
naus	Toter
nauþjan	nötigen, zwingen
nauþs	Not, Zwang
nawis	tot
nawistr	Grab, Totenlager
nawistrōn	begraben
nawiswaran	totschwören
nb	52
ne	nein, nicht
nēdrō	Natter, Schlange
nēƕ	nahe
nēƕa	nahe
nēƕis	näher
nēƕjansik)	sich jemandem nähern
nēƕundi	Nähe
nēƕundja	Nächster
nei	nicht
neiþ	Neid
neiwan	es auf jemand abgesehen haben, grollen
nēm	Nehmen
nēmeigs	nehmend
nēms	nehmend
nēþla	Nadel
ni	nicht
nibai	doch nicht etwa, wenn nicht, es sei denn dass, ausgenommen
nidwa	Verzehren, Rost
nih	und nicht, auch nicht, nicht
niman	nehmen, annehmen, aufnehmen, empfangen, fangen
nisan	genesen, gerettet werden
nists	Rettung, Heil, Genesung
niþan	helfen, unterstützen
niþjis	Verwandter
niþjō	Verwandte
niþþan	und dann nicht, auch dann nicht
niu	nicht, nicht wahr
niuhseins	Heimsuchung
niuhsjan	auskundschaften, heimsuchen
niujan	erneuern, sich erneuern
niujasatiþs	Neubekehrter, Neuling
niujis	neu, jung
niujiþa	Neuheit
niuklahei	Kleinmut, Unverstand
niuklahs	unmündig, kindisch
niun	neun
niunda	neunte
niungeldo	Neungeld, neunfaches Entgelt
niuntēhund	neunzig
niutan	treffen, erreichen, einer Sache froh sein
niuþs	Verlangen
nōhjan	genügen
nōhnan	genügen
nōhs	genug
noicz	Not, nRune
nōta	Achterdeck, Schiffshinterteil
nū	nun, jetzt, also, folglich, demnach
nūh	denn
numja	Nehmer
numts	Nehmen, Annahme
nūnū	demnach, daher, also
nuta	Fänger, Fischer
nuts	nütz, nützlich, brauchbar
ō	ach, oh, pfui
ofts	hoch
ōgan	fürchten
ōgjan	einen schrecken, in Furcht setzen, erschrecken
ōsanna	hosianna, hilf doch
Ostrogoþi	Ostgoten
ōþal	Stammgut, Erbsitz, oRune
ōþli	Stammgut, Erbsitz, Heimat
oy	890
paida	Leibrock, Unterkleid, Rock
paidōn	bekleiden
paíntēdags	Donnerstag
paíntēkustē	Pfingsten
paírþra	pRune
papa	Presbyter, Geistlicher
paraklētus	Tröster
paraskaíwē	Rüsttag
pareinsdags	Freitag
parra	Spalier
paska	Ostern
paúrpura	Purpur
paúrpurōn	mit Purpur färben
paúrpurōþs	purpurn
pauta	Pfote
peika	Spitze
peikabagms	Palmbaum
pistikeins	unverfälscht, echt
plapja)	Straße
plat	Flicken, Lappen
plinsjan	tanzen
plōgs	Pflug
pragga	Beengung
praggan	drängen
praitōriaún	Prätorium, Gerichtshaus
praízbwtaírei	Ältestenrat, christliche Gemeindebehörde
praúfēteis	Prophetin
praúfētes	Prophet
praúfētja	Weissagung, Prophezeiung
praúfētjan	weissagen, prophezeien
psalmō	Psalm
puggs	Geldbeutel, Beutel
pund	Pfund
q	q, Abkürzung für 6
qainōn	weinen, trauern, beweinen, betrauern
qaírnus	Mühle
qaírrei	Sanftmut
qaírrus	sanft, freundlich
qaírþra	Apfelbaum, Köder, qRune
qaíru	Pfahl, Stachel
qaiwjan	Feuer anzünden, lebendig machen
qēniþs	beweibt
qēnjan	heiraten
qēns	Eheweib, Ehefrau, Frau
qēþs	aussprechbar
qidi	Rede
qilan	zur Ruhe kommen
qiman	kommen
qinakunds	weiblichen Geschlechts
qinein	Frauenzimmer, Weibchen
qineins	weiblichen Geschlechts
qinō	Weib, Frau
qiss	Rede
qisteins	Verderben
qistjan	verderben
qistnan	zugrunde gehen
qists	Verderbnis, Untergang
qiþan	sagen, meinen, bezeichnen, sprechen
qiþr	Magen
qiþuhaftō	Schwangere
qiþuhafts	schwanger
qiþus	Magen, Mutterschoß, Bauch
qiujan	beleben
qiunan	aufleben
qius	lebendig
qrammiþa	Feuchtigkeit
qramms	feucht
qums	Ankunft, Wiederkunft
qumþs	Kommen
r	r, Abkürzung für 100
rabbaúnei	Rabboni
rabbei	Rabbi
ragin	Rat, Beschluss
ragineis	Ratgeber, Ratsherr
ragini	Amt
raginōn	verwalten, herrschen
ragins	angeordnet
rahna	Raub
rahnjan	rechnen, berechnen, halten für, rechnen unter, anrechnen
rahtōn	darreichen
raida	Wagen, rRune
raideins	Anordnung
raidjan	verordnen, darbieten
raidjan	bewegen machen, tragen
raíhtaba	recht, richtig
raíhtei	Richtigkeit
raíhteins	Richtung, Wiederherstellung
raíhtis	nämlich, doch, etwa, vielmehr, ja doch, denn
raíhtiþa	Richtigkeit
raíhtjan	richten
raíhts	recht, gerade, gerecht
raip	Riemen
raisjan	aufrichten
raiþs	geordnet
rak	Rede
raka	Sorge
raka	Rechen
raka	eitler Mensch, Tor
rakjan	recken
ram	stark
rampa	Haken, Kralle
ran	Keil
randa	Rand
randus	Schild, Schildrand
ranneins	Laufen
rannjan	laufen machen
rapōn	raffen, rauben
rappa	Krätze, Räude
rasa	Ruhe
rasta	Meile
raþan	zählen
raþjan	reden
raþjō	Abrechnung, Rechenschaft, Zahl
raþs	leicht
rauba	Raub, Beute, Kleid
raubōn	rauben
raúhtjan	zürnen
raupa	Beute, Kleid
raupjan	raufen, ausrupfen
raus	Rohr
raus	Ruhm
rausa	Kruste
raustjan	rösten
rauþs	rot
razda	Sprache, Sprechweise, Zunge
razn	Haus
razzjan	kratzen, schaben
rēdan	raten
rēhsns	Bestimmung, Plan
reidan	reiten, in Bewegung sein
reikeis	mächtig
reiki	Reich, Herrschaft, Obrigkeit
reikinōn	herrschen über, beherrschen
reiks	Herrscher, Obrigkeit
reiran	zittern
reirō	Zittern, Erdbeben, Beben
reisan	erheben
rēþs	Rat
rib	112
ribja	Rippe, Riff
rift	Kleid
rigilō	Strick
rign	Regen
rignjan	regnen, regnen lassen
rikan	häufen, anhäufen
rimis	Ruhe
rinnan	rennen, laufen
rinnō	Gießbach
rintsch	Berg
riq	116
riqis	Finsternis
riqizeins	finster
riqizjan	finster werden, dunkel werden
rists	Erheben
riuban	zerreißen
riudan	erröten
riudei	Röte
riudi	Röte
riurei	Vernichtung, Vergänglichkeit
riureis	vergänglich, sterblich
riurjan	verderben
rk	120
rkb	122
rkg	123
rkh	128
rlg	133
rmh	148
rnq	156
rōdeins	Reden
rōdjan	sprechen, reden
rōhsns	Hof, Vorhof
Rugeis	Rugier
rugi	Roggen
rukka	Rocken, Spinnrocken
rūm	Raum, Platz
Rūma	Rom
rūman	Platz machen
rūmnan	Platz werden
Rūmōneis	Römer
rūms	geräumig
rūna	Geheimnis, Beschluss, Anschlag
rūni	Beratung
runjō	Lauf, Fluss
runs	Lauf, Fluss
runs	Lauf
rupatjan	sich erbrechen
rus	Rost
rusma	rot
sa	der, dieser
saba	weise
saban	feine Leinwand
sabbatō	Sabbat
sada	hundert
Saddukaieis	Saduzäer
saei	der, welcher
sag	Mann, Genosse
saggqjan	senken
saggqs	Untergang, Westen
saggws	Gesang, Musik
sagja	Gefolgsmann, Begleiter, Büttel, Ansager, Gerichtsbote, Verkünder
sagjis	Gefolgsmann, Begleiter, Büttel, Ansager, Gerichtsbote, Verkünder
sah	der und kein anderer, eben der, und dieser
sahrja	Korb
sahs	Schwert, Messer
sahtaba	bestreitbar
sahts	Vorwurf
sahts	bestritten
saƕazuh	wer auch immer
sai	siehe
sáian	säen
saíhs	sechs
saíhsta	sechste
saíƕan	sehen
sail	Seil
sailjan	seilen
sainjan	zögern, säumen
sainus	langsam, saumselig
saio	Gefolgsmann, Begleiter, Büttel, Ansager, Gerichtsbote, Verkünder
sair	Schmerz
saiwala	Seele
saiws	See, Marschland
sakan	streiten, schelten, Vorwürfe machen
sakjō	Streit
sakkus	Sack
sakuls	streitsüchtig
salba	Salbe
salbōn	salben
salbōns	Salbe
saldra	leichtfertiges Geschwätz
saliþwa	Herberge, Wohnung
saljan	herbergen, bleiben, unterkommen, Herberge finden
saljan	opfern
sals	Saal
salt	Salz
saltan	salzen
saltans	gesalzen
salwa	heil
sama	derselbe, der nämliche, sam
samafraþjis	gleichgesinnt
samakuns	desselben Geschlechts, verwandt
samalauþs	gleich groß, derselbe
samaleikō	auf gleiche Weise, gleichfalls, ebenfalls, desgleichen
samaleiks	gleich, übereinstimmend, gleichlautend
samana	zusammen, gemeinschaftlich, zugleich
samaqiss	Übereinstimmung
Samareitēs	Samariter
samasaiwals	einmütig
samaþ	zusammen, nach demselben Ort hin
samjan	zu gefallen suchen, gefallen
sanda	Sendung
sandjan	senden
sanþs	wahr, wahrhaftig
sarwa	Waffen, Rüstung
sateins	Setzung
satiþs	Gesetzter
satjan	setzen, stellen, bestimmen, pflanzen
saþs	satt
saúhts	Krankheit, Sucht
sáuil	Sonne
sauleins	Beschmutzung
sauljan	schmutzig machen
sauljō	Sumpf, Schmutz
saulnan	schmutzig werden
sauls	Säule
Saúr	Syrer
saúrga	Sorge, Kummer
saúrgan	sorgen, bekümmert sein
Saúrini	Syrerin
Saúrja	Syrien
saurjan	dörren
sauþa	Grund, Weise
sauþs	Opfer
scancia	Schenk
scaptus	Schaft
schediit	Licht
scrama	Schwert
Seidoneis	Sidoner
seil	Kraft
seinagaírns	selbstsüchtig, eigensüchtig
seins	sein
seiteins	täglich
seiþs	später
seiþus	spät
sēlei	Tüchtigkeit, Güte, Milde
sēls	gut, gütig, tauglich
sēti	Sitz
sēþs	Saat
sibakþani	du hast mich verlassen
sibja	Sippenverhältnis, Verwandtschaft, Sippe
sibjis	gerecht, gesetzlich
sibjōn	sich versöhnen
sibun	sieben
sibunda	siebte, siebente
sibuntēhund	siebzig
sidōnsis)	üben
sidus	Sitte, Gewohnheit
sifan	sich freuen, frohlocken
siggwan	singen, vorlesen, rezitieren
sigis	Sieg
sigislaun	Siegeslohn, Siegespreis, Preis
sigljan	einen mit einem Siegel versehen, siegeln
sigljō	Siegel
sigqan	sinken
sigus	Sieg
sik	sich
sikls	Sekel
silan	still sein
silba	selbst
silbasiuneis	Augenzeuge
silbawiljis	freiwillig
silda	selten, seltsam
sildaleik	Staunen, Verwunderung
sildaleikjan	anstaunen, bewundern, staunen, sich wundern
sildaleiknan	bewundert werden
sildaleiks	erstaunlich, wunderbar
silubr	Silber
silubreins	silbern
simlē	einst, vordem, vormals
sinaps	Senf
sineigs	alt
siniskalks	ältester Diener, Altknecht, Seneschall
sins	alt
sinteinō	immer, allezeit
sinteins	täglich
sinþan	reisen, gehen
sinþs	Gang
sipōneis	Schüler, Jünger
sipōnjan	Schüler sein
sis	klagen
sisi	Totenklage
sitan	sitzen
sitls	Sitz, Stuhl, Wohnstätte, Nest
siudan	sieden
siujan	nähen, annähen
siukan	siechen, siech sein
siukei	Krankheit, Seuche, Siechtum
siuks	krank, schwach, siech
siuneis	Seher
siuniba	sichtbar
siuns	Gesicht, Sehen, Sehkraft, Gestalt, Erscheinung, Augenschein, Vision
siuns	sichtbar
siurjō	Krebsmilbe
skaban	schaben, scheren, abschneiden
skadus	Schatten
skadweins	Bedeckung
skadwjan	beschatten
skaftjansik	sich bereit machen, sich anschicken
skafts	Schaft
skafts	geschaffen, bereit, fertig
skafts	Geschöpf, Schaffung
skagkja	Schenk
skagkjan	einschenken, schenken
skaidan	scheiden, trennen
skaideins	Scheidung
skaidnan	geschieden werden, sich scheiden
skaírmjan	schirmen
skaírnjan	spotten
skairpa	Ausstattung, Ausrüstung
skalja	Ziegel
skalkinassus	Knechtschaft, Dienst, Dienstbarkeit, Gottesdienst
skalkinōn	dienen
skalks	Knecht, Diener
skama	Scham, Beschämung
skamansik	sich schämen
skanda	Schande
skapja	Schenk, Schenkdiener
skapjan	schaffen
skapt	Schaft
skarda	Scharte
skarja	Scharführer
skarjan	reißen
skarpa	Schuh
skarpa	Stütze, Halt, Böschung
skattja	Wechsler, Geldwechsler
skatts	Geld, Geldstück, Mine
skaþaliggs	Schädling
skaþis	Schaden, Unrecht
skaþjan	schaden
skaþuls	schädlich
skaudaraip	Riemen, Schuhriemen
skaunei	Gestalt
skauns	anmutig
skaúrō	Schaufel
skaúrpjō	Skorpion
skauts	Zipfel, Schoß
skb	222
skeima	Leuchte
skeinan	scheinen, leuchten, glänzen, aufblitzen
skeireins	Auslegung, Erklärung
skeirja	Erklärer, Übersetzer
skeirjan	auslegen, erklären
skeirs	klar, deutlich, hell
skeitan	scheißen
skēwjan	wandern
skg	223
skildus	Schild
skilja	Fleischer, Metzger
skilla	Schelle, Glocke
skilliggs	Schilling
skip	Schiff
skiuban	schieben
skiutan	schießen
skōhs	Schuh, Sandale
skōhsl	böser Geist, Dämon
skorr	Klippe
skorristr	Felsboden
skramma	Schwert, Messer
skreitan	reißen
skritnan	reißen
skuft	Haupthaar
skuggwa	Spiegel
skula	Schuldner, Schuldiger
skulan	schuldig sein, sollen, schulden, müssen
skuld	Erlaubnis, Schuld
skuldō	Geschuldetes, Schuld
skulka	Späher
skūms	Schaum
skuppa	Schopf
skūra	Schauer
Skwþus	Skythe
sl	230
slahals	Raufbold
slahan	schlagen, hauen, ohrfeigen
slahs	Schlag, Plage, Ohrfeige
slahta	Stamm, Geschlecht
slaíhts	schlicht, glatt
slaufa	Fruchthülse
slaúhts	Schlachten, Schlachtung
slaupjan	streifen
slawan	schweigen
slawiþa	Schlaffheit
sleipan	schlüpfen
sleipjan	schleifen, schlüpfen
sleiþa	Schaden
sleiþei	Gefahr
sleiþjan	schädigen
sleiþs	schlimm, gefährlich
slēpan	schlafen
slēps	Schlaf
slimbs	schief
slindan	schlingen
slipjan	schlüpfen
slitjan	zerreißen
sliupan	schleichen, schlüpfen
smaírþr	Fett, Schmer
smakka	Feige
smakkabagms	Feigenbaum
smals	klein, gering
smaltjan	verdauen, zerfließen machen
smalts	Schmelz
smarna	Mist, Kot
smeitan	streichen, schmieren
smikwa	Schminke
smiþa	Schmied
smiþōn	bewirken
smiþs	Schmied
smiugan	schmiegen
smwrn	Myrrhe
smz	247
snaga	Gewand, Mantel, Oberkleid
snaírpan	zusammenziehen, sich biegen, krümmen
snaiws	Schnee
snarpjan	zusammenziehen machen
snd	254
sneiþan	schneiden, ernten
sneiwan	schneien
snills	schnell
snippa	Schnepfe
sniumjan	eilen
sniums	schnell
sniumundō	eilends, eilig
sniwan	eilen, überkommen
snōbō	Bund, Band
snōrjō	Korb, Netz
snōrs	Schnur
snutrei	Weisheit
snutrs	weise
snuzō	Schwiegertochter, Verlobte
sōkāreis	Forscher, Sucher
sōkeins	Untersuchung
sōkja	Sucher
sōkjan	suchen, disputieren, streiten
sōkns	Untersuchung, Disputation, Streitfrage, Grübelei
sōks	streitig
sōna	Sühne
sōþ	Sättigung
sōþjan	sättigen
spadingus	Kämpfer
spaíha	Späher, Spion
spaíhōn	spähen
spaíkulatur	Späher
spaiskuldr	Speichel
sparra	Sparren
sparuks	Sperling
sparwa	Sperling
sparwāreis	Sperber
spaúra	Sporn
spaúrds	Rennbahn, Stadium
spēdiza	spätere
speiwan	speien
spēþs	spät
speuts	Spieß
spilda	Tafel, Schreibtafel, Gesetzestafel
spill	Sage, Fabel
spilla	Verkünder, Verkündiger
spillōn	künden, verkünden, erzählen
spinnan	spinnen
spitus	Bratspieß
spiuts	Spieß
spōla	Spule
sprautō	schnell, bald, ohne Zögern
spriutan	sprießen, hervorschießen
spwreida	Korb
stadjan	zum Stehen bringen
stafs	Element, Stab, Buchstabe
stagga	Stange
staggan	stechen
stagqjan	stoßen
staiga	Steig, Weg
stainahs	steinig
staineins	steinern
stainjan	steinigen
stains	Stein, Fels
staírnō	Stern
staírō	die Unfruchtbare
staka	Stecken, Pfahl
stakeins	Steckung
stakjan	stecken
stakkōn	anpfählen, anbinden
staks	Mal, Wundmal
stald	Haben
staldan	haben, eignen
stalds	habend, erwerbend
stalla	Stall
stamms	lallend, stammelnd
stampa	Stampfe
stampjan	stampfen
stampōn	stampfen
standan	stehen
stap	Ziege
starks	stark
stasseis	Steher
staþa	Ufer, Gestade
staþa	Ständer
staþjis	Steher
staþs	Stätte, Ort, Gegend, Platz, Raum
stáua	Gerichtsstätte, Gericht, Urteil, Streitsache
stáua	Richter
stáuastōls	Richterstuhl
staúrknan	verdorren
staúrmjan	stürmen
staúrms	Sturm
staúrran	starr sein
stautan	stoßen
stega	zwanzig
steigan	steigen
stibna	Stimme
stiga	Steige
stiggils	Stengel
stigqan	stoßen, zusammenstoßen
stika	Stecken
stikan	stechen
stikils	Stachel
stikls	Becher, Kelch
stiks	Stich, Punkt
stilan	stehlen
stiur	Stierkalb
stiur	Pfahl, Steuerung
stiurei	Steuerung
stiuri	Pfahl, Steuerung
stiuriba	gezügelt
stiurjan	aufstellen, geltend machen, feststellen
stiurs	gezügelt
stiwiti	Geduld, geduldiges Ertragen
stōdeins	Stehen
stōjan	richten, beurteilen
stōls	Stuhl, Thron
stōma	Wesen, Gegenstand, Zuversicht, Erwartung, Grundlage, Stoff
stōþan	aufrechterhalten
stōþs	stet
strappōn	straffen
strau	Stroh
straujan	streuen, ausbreiten
straupjan	abstreifen
straupōn	streifen
strava	Scheiterhaufen zur Leichenfeier
streikan	streichen
strigga	Nessel, Riemen
striks	Strich
stubjus	Staub
stuggjan	stechen, stoßen
stuggq	Stoß
stuggs	Stich, Stoß
stunda	Standplatz
stunda	Zeitraum, Zeit
stūriliggs	junger Krieger
stutja	Stütze
stuþjan	anbinden
sugil	Sonne, sRune
sulja	Sohle, Sandale
sūljan	gründen
suman	einst, ehemals,, zum Teil
sums	irgendein, ein gewisser, jemand, ein, einige
sundi	Sünde
sundrō	abgesondert, besonders, allein, beiseite
sunja	Wahrheit
sunjaba	in Wahrheit
sunjeins	wahr, wahrhaft
sunjis	wahr
sunjōn	entschuldigen
sunjōns	Verteidigung
sunnō	Sonne
suns	alsbald, plötzlich, auf einmal, bald, sogleich
sunsaiw	sogleich
sunsei	sobald als
sunþar	südlich
sunus	Sohn
sūpa	Trank
sūpan	saufen
supōn	würzen, salzen
suppa	eingetunkte Schnitte
suppōn	einweichen
suqn	Magen
suqnan	krank werden
sūs	Sau
sūti	Ruhe, Milde
sūtis	nachgiebig, mild
suþjan	kitzeln
suþjōn	kitzeln
swa	so
swaei	so dass, daher, also
swaggwjan	schwanken machen
swah	so, so auch
swaíhra	Schwiegervater, Schwäher
swaíhrō	Schwiegermutter
swaírban	wischen
swalauþs	so groß, so viel
swaleiks	so beschaffen, solch
swalleins	Schwellung
swalljan	schwellen
swamms	Schwamm
swans	Schwan
swara	Schwörer
swaran	schwören
swarē	ohne Grund, vergebens, umsonst
swartis	Schwärze, Tinte
swartizl	Schwärze, Tinte
swartjan	schwärzen
swarts	schwarz
swaswē	sowie, gleichwie, wie, gegen, so dass
swaþþan	so nun
swau	so
swē	wie, gegen, als, da
Swēbōs	Schwaben, Sweben
swēgniþa	Jubel, Frohlocken, Freude
swēgnjan	jubeln, triumphieren, frohlocken
swēgns	froh, fröhlich
sweiban	ablassen, aufhören
sweibands	aufhörlich
swein	Schwein
sweins	Sau
sweipains	Fegung
sweipan	fegen, sich schwingend bewegen
Swēōs	Schweden
swēran	ehren, achten
swērei	Ehre
swēriþa	Ehre
swērs	geehrt, geachtet, gewichtig
swēs	eigen, angehörig
swēs	Eigentum, Vermögen
swēþauh	doch zwar, wenigstens
swibls	Schwefel
swiggwan	sich schwingen
swigl	Flöte
swiglja	Flötenspieler, Flötenbläser
swiglōn	Flöte blasen, aufspielen
swiknaba	rein, reinen Herzens
swiknei	Reinheit, Keuschheit, Unschuld
swikneins	Reinigung
swikniþa	Reinigung, Reinheit, Keuschheit
swiknjan	reinigen
swikns	rein, unschuldig, unsträflich, keusch
swikunþaba	offenbar, offen heraus, deutlich, ausdrücklich
swikunþjan	bekanntgeben, offenbaren
swikunþs	offenkundig, offenbar, bekannt
swillan	schwellen
swiltan	im Sterben liegen, sterben
swimman	schwimmen
swinþei	Stärke, Kraft
swinþjan	stärken
swinþnan	stark werden
swinþs	stark, kräftig, gesund
swistar	Schwester
swnagōgafaþs	Synagogenvorsteher
swnagōgē	Synagoge
swōgan	rauschen, tönen
swōgatjan	seufzen
swōgjan	seufzen
swōgs	Geräusch
swultawaírþja	dem Tode Naher, Todgeweihter
swultawaírþs	auf den Tod gerichtet, todgeweiht
swults	Tod
swumfsl	Teich
t	t, Abkürzung für 300
taban	Opfer, Opfertier
taddora	Zottel, Fetzen, Flausch
tagl	Haar
tagr	Zähre, Träne
tagrjan	weinen
tahanjan	zäh sein, streiten
taheins	Zerreißung
tahjan	reißen, zerren, ausstreuen
tāhus	zäh
taíhswa	rechte
taíhswa	die Rechte, die rechte Hand
taíhun	zehn
taíhunda	zehnte
taíhuntaíhundfalþs	hundertfältig
taíhuntēhund	hundert
taíhuntēweis	zehnreihig
taikn	Anzeichen
taikneins	Zeichnung, Darstellung
taiknjan	einem etwas zeigen
taikns	Zeichen, Wunder
tainjō	Korb, Weidenkorb
tains	Zweig, Rebe
taíran	zerstören, zerreißen, auflösen
Taírwiggōs	Waldbewohner
taítrarkēs	Tetrarch, Vierfürst
taleiþa	Mägdlein
talōn	verwüsten, wegreißen
tals	fügsam, gehorsam
talzeins	Lehre, Unterweisung
talzjan	lehren, ziehen, unterrichten
talzjands	Lehrer
tamjan	zähmen
tams	zahm
tandjan	anzünden, brennen machen
tappa	Zapfen
tarhjan	kennzeichnen
tarmjan	losbrechen, ausbrechen
tarnjan	rauben
taskōn	raffen
taturō	Zotte
taúhts	Ziehung, Führung
táui	Werk, Tat
taujan	tun, machen, wirken
taujands	Täter
taúra	Riss
taúrnan	reißen
taúrþs	Zerstörung
tē	bis, zu
tēhund	zig
teihan	kündigen, zeigen
tēkan	anrühren, berühren
telich	töricht
tēlōn	schaden
tēmiba	ziemend
tēms	ziemend
Tērvingi	Waldbewohner, Westgoten
tēwa	Ordnung
tēweis	teilig
tēwjan	anordnen
the	der
thīnita	elf
thīntria	dreizehn
thīntua	zwölf
tibr	Opfer
tigjus	Zehnzahl, ...zig
tilamalsks	besonnen
tilarēþs	Zielrat
tilōn	zielen, streben
tils	zielstrebig, passend, geschickt
timan	sich ziemen, geziemen
timr	Bauholz
timreins	Erbauung
timrja	Zimmermann
timrjan	bauen, zimmern, erbauen
timrjō	Bau, Gebäude
tiuhan	ziehen, führen, wegführen
tiuhi	Ruck, Zug
tk	320
tlg	333
tme	345
tōjis	getan habend, tuend, Tuer
tōl	Gefahr
tráuains	Vertrauen, Zuversicht
tráuan	trauen, Zutrauen haben
trausti	Bündnis, Bund, Vertrag
trausts	stark, fest
trigan	trauern, betrüben
triggwa	Bündnis, Bund
triggwaba	treulich, zuverlässig
triggws	treu, zuverlässig
trigō	Trauer, Unlust
trimpan	treten
triniungeldo	Dreineungeld, Siebenundzwanzigfachentgelt
trippōn	trippeln, hüpfen, springen
triu	Holz, Prügel, Baum
triweins	hölzern
trudan	treten, keltern
trusnjan	streuen
tufa	Helmbüschel
tuga	Zieher, Führer
tuggl	Gestirn
tuggō	Zunge
tuld	Zelt, Vorhang
tulgiþa	Festigkeit, Sicherheit, Fundament, Grundfeste, Befestigung
tulgjan	festigen, stärken, befestigen
tulgus	fest, beständig, standhaft
tūn	Zaun
tundi	Dorn, Zahn
tundnan	brennen
tunþus	Zahn
tuz	zer…
tuzwērjan	zweifeln
tuzwērs	verdächtig
twai	zwei
twaitigjus	zwanzig
twalibwintrus	zwölfjährig
twalif	zwölf
tweifleins	Zweifeln, Bezweiflung
tweifljan	zweifeln, in Zweifel versetzen
tweifls	Zweifel
tweifls	zweifelhaft
tweihnai	je zwei
twis	entzwei
twisstandan	sich trennen, Abschied nehmen von
twisstass	Zwistigkeit, Zwiespalt
tyz	Ziu, Kriegsgott, Siegesgott, tRune
þ	th, Abkürzung für 9
þadei	wohin, dorthin wo
þagkjan	denken, überlegen
þagks	Dank
þahains	Schweigen
þahan	schweigen
þāhō	Lehm, Ton
þahsus	Dachs
þaírh	durch
þaírharbaidjan	durcharbeiten
þaírhbaíran	hindurchtragen
þaírhgaggan	hindurchgehen, vorübergehen, herumgehen, durchstreifen
þaírhgaleikōn	deuten, auf jemanden übertragen, beziehen auf
þaírhleiþan	hindurchgehen, vorbeigehen, weitergehen
þaírhsaíƕan	durchschauen, im Spiegel erblicken
þaírhwakan	durchwachen, unter freiem Himmel übernachten, biwakieren
þaírhwisan	verbleiben, verharren
þaírkō	Loch, Nadelöhr
þaírsan	verdorren
þakjan	decken
þan	dann, darauf, wann, so lange als, als, da
þana	dann
þanamais	weiter, noch, mehr
þanaseiþs	weiter, noch
þandē	wenn, weil, so lange als, da
þanei	wann, wieviel
þanjan	strecken, dehnen
þannu	ja, wohl, also darum
þanuh	dann, daher, also, aber, nun
þar	dort, daselbst, da
þarba	Mangel, Armut
þarban	darben
þarbs	nötig, bedürftig
þarei	wo
þarihs	ungewalkt
þaruh	da, nun, aber, daselbst
þatain	das eine
þatainei	nur
þatei	dass, weil, als ob
þaþrō	daher, von da, darauf, hinfort, für die Zukunft
þaþrōei	von wannen, woher, von wo
þaþrōh	von da, daher, darauf, darnach
þau	als, oder, doch, wohl, etwa, wie
þauh	oder, doch
þauhjabai	wenn auch
þaúr	Riese
þaúrban	nötig haben, bedürfen, Mangel leiden
þaúrbs	enthaltsam
þaúrfts	nötig, nützlich, notwendig
þaúrfts	Bedürfnis, Notdurft, Not
þaúris	Riese
þaúrneins	von Dornen, dornen
þaúrnja	Dornbusch
þaúrnus	Dorn
þaúrp	bebautes Land, Acker, Feld
þaúrpan	vergleichen
þaúrsiþs	durstig
þaúrsjan	dürsten
þaursnan	verdorren, vertrocknen
þaúrstei	Durst
þaúrsts	durstig
þaúrsus	dürr, vertrocknet
þē	desto, um so
þēei	darum dass, deshalb dass, als ob, als wenn
þei	was auch immer, dass, damit
þeihan	gedeihen, Fortschritte machen
þeihs	Zeit
þeihwō	Donner
þeins	dein
þēwis	Dienerschaft, Knechte
þiljō	Diele, Planke, Brett
þinsan	ziehen
þiqjan	dick werden
þishun	meist, vorzüglich, besonders
þisƕaduh	wohin auch immer, wohin nur immer
þisƕaruh	wo auch immer, wo nur immer
þisƕazuh	wer auch immer, wer nur immer
þiubi	Diebstahl
þiubjis	diebisch, heimlich
þiubjō	verstohlen, heimlich
þiuda	Volk, Heiden
þiudangardi	Königsschloss, Königreich, Palast
þiudanōn	herrschen, König sein
þiudans	König
þiudinassus	Regierung, Königreich, Reich
þiudiskō	heidnisch
þiufaþia	Tausendschaft
þiufaþs	Knechtführer, Tausendführer
þiufaþus	Knechtführer, Tausendführer
þiufs	Dieb, Räuber
þiuh	Oberschenkel, Hüfte
þiuhbrōks	Kniehose
þiumagus	Knecht
þius	Haussklave, Diener, Knecht
þiuþ	das Gute, die gute Sache, Gut
þiuþan	lärmen
þiuþei	Güte
þiuþeigs	gut, gepriesen
þiuþeins	Güte, Segen
þiuþiqiss	Segen, Segnung
þiuþjan	segnen
þiuþs	gut
þiuþspillōn	Gutes künden, frohe Botschaft künden, verkündigen
þiwadw	Knechtschaft, Dienstbarkeit
þiwairna	Magd
þiwan	dienstbar machen
þiwi	Magd
þlahsjan	schrecken, erschrecken
þlahsnan	erschrecken
þlaihan	ermahnen, trösten
þlaihts	Trost
þlaqus	zart
þlaúhs	Flucht
þliuhan	fliehen
þrafsteins	Trost, Tröstung
þrafstjan	trösten, mahnen, ermahnen
þrafsts	Trost
þragjan	laufen
þraihn	Menge
þramstei	Heuschrecke
þras	schnell, verwegen
þrasabalþei	Streitsucht
þrasabalþs	streitsüchtig
þreihan	drängen
þreihsl	Drangsal, Bedrängnis
þreis	drei
þreistigjus	dreißig
þridja	dritte
þridjataihun	dreißig
þridjō	zum dritten Mal
þrimman	schwellen
þriskan	dreschen
þriutan	schwerfallen
þrōþjan	üben
þruks	Druck, Stoß
þrūtsfill	Aussatz
þrūtsfills	aussätzig
þrūþs	Kraft
þū	du
þūei	der du
þufaz	Fahne, Büschel
þugkjan	glauben, meinen, gelten, erscheinen, dünken
þūhts	mütig, dünkend
þūhtus	Gewissen
þulains	Dulden, Leiden, Geduld
þulan	dulden, leiden
þulds	Geduld
þunara	Donnerer, Donar
þund	schwellen
þunds	Held
þūs	groß, Kraft
þūsundi	tausend
þūsundifaþs	Tausendführer, Anführer von Tausend
þuthaúrn	Trompete
þuthaúrnjan	trompeten
þuts	Lärm
þwahan	etwas waschen, sich waschen
þwahl	Bad, Taufe
þwaírhei	Zorn, Streitigkeit, Streit
þwaírhs	quer, zornig
þwastiþa	Sicherheit
þwastjan	befestigen
þwasts	fest
þwmiama	Rauchopfer, Räucherwerk
u	u, Abkürzung für 70
u	ob, oder
ubil	Übel
ubilaba	übel, böse
ubils	übel, böse, schlecht
ubiltōjis	übeltäterisch, Übeltäter
ubilwaúrdjan	übel sprechen, schmähen
ubilwaúrds	übelredend, schmähsüchtig
ubizwa	Halle
ubuh	unter
ud	74
uf	unter
ufaiþeis	durch Eid verpflichtet, durch Eid verbunden, vereidet
ufanus	der seinen Überfluss zeigt
ufar	über
ufara	obere
ufarassjan	überfließend machen, überschwänglich machen, überfließen, im Überfluss vorhanden sein
ufarassus	Überfluss, Übermaß
ufarfullei	Überfülle, Überfluss
ufarfulljan	überfüllen
ufarfulls	festgedrückt, übervoll
ufargaggan	etwas übertreten, übergreifen, überschreiten
ufargiutan	übergießen, übervoll gießen
ufargudja	Oberpriester, Mitglied des Synhedrions
ufarhafjan	überheben
ufarhafnan	sich überheben
ufarhamōn	überziehen, sich mit etwas überkleiden, sich anziehen
ufarhauhjan	überhöhen, verblenden
ufarhauseins	Überhören, Ungehorsam
ufarhausjan	überhören
ufarhiminakunds	himmlisch
ufarhleiþrjan	überzelten, ein Zelt über jemandem aufschlagen
ufarhugjan	sich überheben
ufarjaina	darüber hinaus
ufarlagjan	überdecken
ufarleiþan	übersetzen, hinüberfahren
ufarmaudei	Vergessenheit
ufarmaudjan	vergessen
ufarmēleins	Überschrift
ufarmēli	Überschrift
ufarmēljan	überschreiben, darüber schreiben
ufarmitōn	vergessen
ufarmunnōn	vergessen
ufarō	darüber, über etwas, über einem, über einer Sache
ufarranneins	Besprengung
ufarrannjan	überrennen, besprengen
ufarskadwjan	überschatten
ufarskafts	Erstlingsfrucht, Anbruch
ufarsteigan	darüber emporsteigen
ufarswara	Meineidiger
ufarswaran	falsch schwören
ufartrusnjan	überstreuen
ufarþeihan	übertreffen
ufarwahsjan	überaus wachsen, sich stark vermehren
ufarwisan	überragend sein, übersteigen, hervorragen
ufbauljan	aufblasen
ufblēsan	aufblasen, sich aufblähen
ufbrikan	verwerfen, verachten
ufbrinnan	verbrennen
ufdaupjan	taufen, eintauchen
ufgaírdan	umgürten
ufgraban	nachgraben, unterwühlen, aufgraben
ufhaban	aufheben, emporhalten
ufhauseins	Gehorsam
ufhausjan	gehorchen, sich an etwas halten
ufhlōhjan	auflachen machen, lachen machen, auflachen
ufhnaiweins	Gehorsam, Unterordnung, Unterwerfung
ufhnaiwjan	einen unterwerfen unter
ufhrōpjan	aufschreien, ausrufen
ufjō	Überfluss
ufkunnan	erkennen, erfahren
ufkunþi	Erkenntnis
ufligan	unterliegen, verschmachten, matt werden, sterben
ufmēljan	unterschreiben
ufrakjan	aufrecken, ausstrecken, hinaufziehen
ufsaggqjan	versenken
ufsliupan	einschleichen, zu Unrecht einführen, sich zurückziehen, sich fortschleichen
ufsneiþan	aufschneiden, schlachten
ufstraujan	darunterstreuen, unterbreiten
ufswalleins	Aufgeblasenheit, Hochmut
ufswalljan	aufschwellen, aufblasen
ufswōgjan	aufseufzen
ufta	oft
uftō	vielleicht
ufþanjan	ausdehnen, ausstrecken, nach etwas trachten
ufwaíra	verheiratet
ufwōpjan	aufschreien, ausrufen
ug	73
ugkar	unser beider
ugkja	Unze
uh	und, nun, also
ūhteigō	zur rechten Zeit, zu gelegener Zeit
ūhteigs	Zeit habend, unbeschäftigt
ūhti	Zeit, Gewohnheit
ūhtiugs	gelegen, passend, zeitgemäß
ūhtwō	Morgendämmerung
ulbandus	Kamel
un	un
unagands	unfurchtsam, furchtlos
unagei	Furchtlosigkeit
unags	furchtlos
unaírkns	unheilig, gottlos
unaiwisks	ohne Schande
unanasiuniba	unsichtbar
unanasiuns	unsichtbar
unandhuliþs	unenthüllt
unandsakans	unbestritten
unandsōks	unbestreitbar, unwiderleglich
unatgāhts	unzugänglich
unbaírands	nicht tragend
unbarnahs	kinderlos
unbaúrans	ungeboren
unbeistei	Ungesäuertsein, ungesäuertes Brot
unbeistjōþs	ungesäuert
unbiari	wildes Tier, Bestie
unbilaistiþs	unaufspürbar, unbegreiflich, unerforscht
unbimait	Nichtbeschneidung, Vorhaut
unbimaitans	unbeschnitten
unbrūks	unbrauchbar
und	bis, zu, für, um etwas, ent
undar	unter
undarists	das Innere, innerste, die untersten
undarleija	Allergeringster, Geringster
undarleis	niedrig, gering
undarō	unter
undaúrnimats	Frühstück, Mittagsmahl
undgreipan	ergreifen, requirieren
undiwanei	Unsterblichkeit
undiwans	unsterblich
undrēdan	besorgen, gewähren
undrinnan	zufallen, zuteil werden, untereinander disputieren
unfagrs	unpassend
unfaírina	tadellos, außer Schuld, ohne Tadel
unfaírinōdaba	untadelig, tadellos
unfaírlaistiþs	unaufspürbar, unerforschlich
unfaurs	geschwätzig
unfaúrweis	unvorsätzlich, ohne Vorbedacht, unbedacht
unfraþjands	unverständig
unfreideins	Schonungslosigkeit, Härte
unfrōdei	Unverstand, Torheit
unfrōþs	unverständig
ungafaírinōnds	tadellos, unbescholten
ungafaírinōþs	tadellos, unbescholten, schuldlos
ungahabandssik	zügellos, unbeherrscht, unenthaltsam
ungahōbains	Unmäßigkeit, Unenthaltsamkeit
ungaƕaírbs	unfügsam, ungehorsam
ungakusans	verwerflich, nicht probehaltig
ungalaubeins	Unglaube, Ungehorsam
ungalaubjands	ungläubig, ungehorsam
ungalaufs	wertlos
ungaraíhtei	Gesetzlosigkeit, Ungerechtigkeit
ungasaíƕans	ungesehen, unsichtbar
ungastōþs	ohne festen Stand, ohne bleibende Stätte
ungatass	ungeordnet, zügellos
ungatassaba	unordentlich, ungeregelt
ungatēwiþs	ungeordnet, unordentlich
ungawagiþs	unbewegt, unbeweglich
unhabands	nicht habend
unhaili	Schwäche, Krankheit
unhails	krank
unhanduwaúrhts	nicht handgemacht, nicht mit der Hand gemacht
unhindarweis	ungeheuchelt
unhrainei	Unreinheit
unhrainiþa	Unreinheit
unhrains	unrein, ungebildet
unhulþa	Unhold, Teufel
unhulþō	Unholdin, Dämon
unhunslags	ohne Opfer, unversöhnlich
unƕapnands	unauslöschlich
unƕeila	unablässig, beständig
unkarja	sorglos, unbesorgt
unkaúreins	Unbeschwerde, Unbeschwerlichkeit
unkunnands	nicht kennend, unwissend
unkunþi	Unkunde
unkunþs	unbekannt
unlēdi	Armut
unlēdjan	arm machen
unlēþs	arm
unliufs	ungeliebt, unlieb
unliugaiþs	unverheiratet
unliugands	nicht lügend
unliuts	ungeheuchelt, ohne Falsch
unlustus	Unlust
unmahteigs	ohnmächtig, schwach, unmöglich
unmahts	Ohnmacht, Schwäche, Krankheit
unmanariggws	ungezähmt, wild, grausam
unmanwus	unvorbereitet
unmilds	lieblos
unnuts	unnütz, töricht
unqēniþs	unbeweibt
unqēþs	unaussprechlich
unriurei	Unvergänglichkeit
unriureis	unvergänglich
unrōdjands	nicht redend, stumm
unsahtaba	unbestritten, unbestreitbar
unsaíƕands	nicht sehend
unsaltans	ungesalzen, kraftlos
unsar	unser
unsēlei	Bosheit, Schlechtigkeit
unsēls	übel, böse
unsibjis	ungesetzlich, gottlos
unskaus	nüchtern
unsūti	Aufstand, Aufruhr
unsweibands	unaufhörlich
unswēran	verunehren, beschimpfen
unswērei	Unehre
unswēriþa	Unehre
unswērs	nicht geachtet, verachtet
unswikunþs	unbekannt
untals	unfügsam, unbotmäßig, ungehorsam, ungebildet, töricht
untē	bis, solange als, denn, weil, da
untilamalsks	voreilig, unbesonnen
untriggws	untreu, ungerecht
unþaþlíuhan	entfliehen, einem entrinnen
unþiuda	Unvolk, Nichtvolk
unþiuþ	das Böse
unþiuþjan	fluchen
unþwahans	ungewaschen
unufbrikands	unanstößig
unūhteigō	zur Unzeit
unūhteigs	unzeitig
unuslaisiþs	unbelehrt, ungelehrt
unusspillōþs	nicht auszuerzählen, unerforschlich
unwāhs	tadellos, untadelhaft
unwaírþaba	unwürdig
unwaírþs	unwürdig
unwammei	Unbeflecktheit, Reinheit, Lauterkeit
unwamms	fleckenlos, tadellos, rein
unwaúrstwō	Untätige, Müßige
unweis	ungebildet, unwissend
unwēniggō	unerwartet, plötzlich, unverhofft
unwērei	Unwille
unwērjan	unwillig sein, zürnen
unwērs	unwillig, zornig
unwiss	ungewiss, ins Ungewisse
unwita	Unwissender, Unverständiger, Törichter
unwitands	unwissend
unwiti	Unwissenheit, Unverstand
unwunands	beängstigt, bekümmert
ur	aus
urraisjan	zum Aufstehen bringen, aufrichten, erwecken, erregen, aufregen
urrannjan	aufgehen lassen
urrēdan	auflegen, bestimmen, urteilen
urreisan	erstehen, sich erheben, aufstehen
urrinnan	auslaufen, ausgehen, aufgehen
urrists	Auferstehung
urrugks	verworfen
urrūmnan	sich erweitern, aufgehen
urruns	Aufgang, Osten, Abtritt
urruns	Ausgang
ūrs	Auerochs, uRune
us	aus, von her, seit, gleich nach
usagjan	einen erschrecken
usagljan	ins Gesicht schlagen, bedrängen, belästigen, beschimpfen
usaiwjan	sich anstrengen
usalþan	alt werden, veralten
usbaíran	hinaustragen, hervorbringen, vorbringen, ertragen
usbalþei	Frechheit, fortwährende Zänkerei
usbalþjan	wagen, sich erkühnen
usbaugjan	ausfegen
usbeidan	erwarten, Geduld haben
usbeisnei	Geduld, Langmut
usbeisneigs	geduldig, langmütig
usbeisns	Erwartung, Geduld, Langmut
usbidan	erbitten
usbliggwan	durchbleuen
usblōtan	bitten
usblōteins	Bitte, Flehen, Gebet
usbraidjan	ausbreiten nach
usbruknan	ausgebrochen werden, abgebrochen werden
usbugjan	erkaufen
usdaudei	Ausdauer, Eifer
usdaudjan	sich beeifern, seine Ehre suchen
usdaudō	eifrig
usdauþs	eifrig
usdreiban	austreiben, vertreiben
usdriusan	herausfallen
usdrusts	rauher Weg
usfaírina	tadellos
usfarþō	Ausfahrt
usfarþōn	ausfahren
usfilh	Begräbnis
usfilhan	begraben
usfilma	erschrocken, entsetzt
usfilmei	Entsetzen
usfōdeins	Nahrung
usfōdjan	nähren
usfraisan	versuchen
usfratwjan	klug machen, ausrüsten, ausstatten
usfulleins	Erfüllung
usfulljan	erfüllen, vollenden, ersetzen, zusammenfassen
usfullnan	erfüllt werden von
usgaggan	ausgehen, hinausgehen
usgaisjan	erschrecken
usgeisnan	sich entsetzen, erstaunen, erschrecken
usgiban	erstatten, bezahlen, darstellen, darbringen
usgildan	vergelten
usgraban	ausgraben
usgrudja	mutlos
usgutnan	verschüttet werden
ushafjan	erheben, wegnehmen
ushāhansik)	sich erhängen
ushaista	Mangel leidend, bedürftig
ushaitan	herausfordern
ushauhjan	erhöhen
ushauhnan	verherrlicht werden, erhöhen, erhöht werden
ushinþan	erbeuten
ushlaupan	aufspringen, sich aufmachen
ushrainjan	ausfegen
ushramjan	kreuzigen
ushrisjan	abschütteln
ushulōn	aushöhlen
uskannjan	verkünden, berichten, empfehlen, kundtun
uskeinan	hervorkeimen
uskiusan	erproben, verwerfen, vertreiben, auswählen
uskunþs	bekannt, offenbar
uslagjan	auflegen, anlegen
uslaisiþs	belehrt, gelehrt
uslaisjan	belehren, lehren
uslaubjan	erlauben
uslauseins	Erlösung
uslausjan	entledigen, entäußern, entleeren, berauben, erlösen, befreien, entwurzeln
usleiþan	hinausgehen, weggehen, verreisen, vergehen
uslētan	ausschließen
usliþa	gichtbrüchig, Gichtbrüchiger
usluk	Eröffnung, Öffnung, Loch
uslūkan	erschließen, öffnen
uslūknan	sich erschließen, sich öffnen
usluneins	Erlösung
uslunjan	erlösen
uslutōn	verführen, irreführen
usmaitan	ausschneiden, abschneiden, ausrotten, aushauen
usmanagnan	sich vermehren, sich reichlich zeigen
usmērjan	verkünden
usmērnan	sich verbreiten, sich ausbreiten
usmēt	Lebensführung, Lebenswandel, Bürgerrecht, Wandel
usmitan	wandeln, leben, sich benehmen
usniman	herausnehmen, wegnehmen, aufnehmen, mitnehmen, annehmen
usqiman	umbringen, den Tod geben
usqiss	Beschuldigung, Anklage, Nachrede
usqistjan	verderben, umbringen, töten, zugrunde richten
usqiþan	ein Gerede verbreiten
usrūmnan	sich erweitern
ussaíƕan	aufblicken, ansehen, das Gesicht wieder erhalten, aussehen, umsehen
ussakan	erörtern, vorlegen, ausführlich vortragen
ussaljan	Herberge nehmen, einkehren
ussandjan	aussenden
ussateins	Ursprung
ussatjan	daraufsetzen, pflanzen, erzeugen, aussenden, zusammensetzen, gründen
ussiggwan	vorlesen, rezitieren
ussindō	am meisten, besonders, ausnehmend
ussinþs	außer dem Weg befindlich, besonders
ussitan	sich aufsetzen, sich aufrichten
usskarjan	nüchtern werden, zur Besinnung kommen, herausreißen
ussōkjan	erforschen, verhören, unterscheiden, bevorzugen, ausforschen
usspillōn	verkünden, erzählen, ausführlich erzählen
usspillōþs	aussprechbar
usstaggan	ausstechen
usstandan	sich erheben, aufbrechen, auferstehen, aufstehen
usstass	Auferstehung
ussteigan	emporsteigen, hinaufsteigen
usstiurei	Zügellosigkeit, Liederlichkeit
usstiuriba	zügellos
usstiurs	zügellos
ustaikneins	Auszeichnung, Bezeichnung, Bekanntmachung, Anzeichen, Beweis, Darstellung
ustaiknjan	bezeichnen, auszeichnen, erweisen, darstellen, in die Erscheinung bringen
ustaúhts	Vollendung, Vervollkommnung, Ende, Erfüllung
ustiuhan	hinausführen, wegführen, entrichten, ausführen, vollbringen, vollenden, herstellen
usþinsan	ziehen
usþriutan	einem Beschwerde bringen, beschwerlich fallen
usþrōþeins	Übung, Stählung
usþrōþjan	einüben
usþulains	Geduld
usþulan	erdulden, ertragen, sich annehmen
usþwahan	auswaschen, abwaschen
uswagjan	erregen
uswahsans	erwachsen
uswahsjan	erwachsen
uswahsts	Wachstum
uswaírpan	hinauswerfen, wegwerfen, austreiben, verwerfen, abwerfen, ablegen, daraufwerfen
uswakjan	erwecken, aufwecken
uswalteins	Umwälzung, Zusammensturz, Zerstörung, Untergang
uswaltjan	etwas umwälzen, etwas umstürzen
uswalugjan	hin und her wälzen, hin und her treiben, umherschleudern
uswandeins	Verführung
uswandi	Abwendung, Irreleiten, Irreführung
uswandjan	sich wegwenden, sich entziehen, verfallen
uswaúrhts	gerecht
uswaúrhts	Gerechtigkeit
uswaúrkjan	ausführen, vollbringen
uswaúrpa	Auswurf, Verwerfung, Fehlgeburt
usweihs	außer der Weihe, unheilig, profan
uswēna	hoffnungslos
uswindan	flechten, winden
uswiss	losgebunden
uswissi	Leichtfertigkeit, Eitelkeit
ūt	hinaus, heraus
ūta	außerhalb, draußen
ūtana	von außen, außen, äußere, außerhalb
ūtaþrō	von außen, außerhalb
ūtbaíran	hinaustragen
ūtgaggan	hinausgehen, ausgehen
uzanan	ausatmen, aushauchen
uzds	Spitze
uzēta	Krippe
wad	Wasser, Furt
waddjus	Wand, Geflecht, Mauer
wadi	Pfand
wadjabōkōs	Handschein, Schuldschein
wadjōn	verloben
wagga	Wange
waggāreis	Kopfkissen
waggō	Wange
waggs	Wiese, Paradies
waghen	Wagen
wagjan	schütteln, bewegen
wāhs	tadelig
wahsjan	wachsen
wahsts	Wachstum
wahstus	Wuchs, Wachstum, Körpergröße, Größe
wahtwō	Wache
wai	wehe
wáian	wehen
waibjan	weben, winden
waida	Weide
waidēdja	Übeltäter, Räuber
waidēþs	Übeltat
waifaírƕjan	wehklagen
waihjō	Kampf
waíhsta	Winkel, Ecke
waíhstastains	Winkelstein, Eckstein
waíht	etwas
waíhts	Ding, Sache, etwas
waíla	wohl, gut, wohlan
waíladēþs	Wohltat
waílamērei	guter Ruf
waílamēreins	Verkündigung, Botschaft
waílamēreis	wohllautend, löblich
waílamērjan	einem eine frohe Botschaft künden, predigen, frohe Botschaft bringen
waílaqiss	Segen
waílaspillōn	verkünden, erzählen, frohe Botschaft verkünden
waílawizns	gute Nahrung, gute Kost
wainahs	elend, geplagt
wainei	wenn doch, dass doch
wainjan	weinen
wainōn	weinen
waipjan	binden
waips	Kranz
waír	Mann
waíraleikō	männlich
waíraleiks	männlich
waírdus	Gastfreund, Hauswirt, Wirt
waírilō	Lippe
waírpan	werfen
waírs	schlimmer
waírsiza	schlimmer
waírþ	Preis, Wert
waírþaba	wert, würdig
waírþan	werden, geschehen, geboren werden, entstehen, kommen, stattfinden, sich ereignen
waírþeigs	friedfertig, friedlich
waírþi	wärtigkeit
waírþi	Wert
waírþida	Tüchtigkeit, Fähigkeit, Wert
waírþis	wärts
waírþja	Naher, Gewärtiger
waírþjan	friedlich sein
waírþnan	friedlich machen, sich versöhnen
waírþōn	schätzen, abschätzen, würdigen
waírþs	wert, würdig, tauglich
waírþs	...wärtig
waitei	vielleicht, etwa
waiþja	Jäger
wajamērei	schlechter Ruf, übler Ruf
wajamēreins	Lästerung
wajamēreis	übelberüchtigt, übel berufen
wajamērjan	lästern
wakan	wachen, wachsam sein
wakjan	wecken
waknan	wach werden
wakrs	wach, wacker
wala	welsch
wala	Tod, Schlachtfeld
walda	Wau, Färberwau
waldan	walten, haushalten, dem Hauswesen vorstehen
waldands	mächtig, Walter
walds	Walter, Herrscher
waldufni	Gewalt, Macht
waldus	Wald
waleins	Wahl
walgjan	wälzen
walhs	welsch, ausländisch
walisa	echt, lauter, geliebt
waljan	wählen
walteins	Wälzung, Sturz
waltjan	sich wälzen, stürzen
walugjan	hin und her treiben
walus	Stab
walwisōn	sich wälzen
walwjan	wälzen
wamba	Bauch, Schoß, Leib
wamm	Fleck
wammei	Beflecktheit
wammjan	beflecken
wamms	schlecht, gemein
wan	Mangel
wanains	Mangel
wanan	mangeln, abnehmen
Wandals	Wandale
wandeins	Wendung
wandi	Wendung
wandjan	wenden
wandus	Gewundenes, Rute
waninassus	Mangel
wans	fehlend, mangelhaft,
warda	Hüterin
wardeins	Werden
wardja	Wächter
wardō	Hüterin
wardōn	beobachten
wards	Wächter, Hüter
warei	Tücke, Verschlagenheit
wargeins	Verurteilung
wargiþa	Verdammungsurteil, Verurteilung, Verdammnis
wargjan	verdammen
wargs	Verdammter, Geächteter
warjan	wehren
warmjan	wärmen
warms	warm
warnjan	sich versehen
warōn	beachten
wars	behutsam, nüchtern, gewahr, vorsichtig
wars	sich wehrend
waseins	Bekleidung
wasjan	einen kleiden, sich kleiden, bekleiden
wasti	Kleid, Kleidung
watō	Wasser
waúrd	Wort
waúrdahs	vernünftig, sich in Worten zeigend
waúrdajiuka	Wortstreit
waúrdei	Gerede
waúrdi	Rede, Wort
waúrhts	getan
waúrhts	Werk, Tat
waúrk	Werk
waúrki	Wirken
waúrkjan	machen, wirken
waúrms	Wurm, Schlange
waúrstw	Werk, Tat, Wirksamkeit
waúrstwa	Arbeiter
waúrstwei	Tun, Verrichtung, Betrieb
waúrstweigs	wirksam
waúrstwja	Arbeiter, Bauer, Winzer
waúrstws	tätig
waúrts	Wurzel
wēgs	Erschütterung, Sturm, Wellenschlag, Brandung, Woge
weida	Führer
weidōn	führen
weif	Weib
weigs	Kampf
weih	Heiligtum, Tempel
weiha	Priester
weihaba	heilig
weihan	kämpfen
weihan	weihen, heiligen
weihiþa	Weihe, Heiligung, Heiligkeit
weihnan	heilig werden, heilig gehalten werden
weihs	heilig, geweiht
weihs	Dorf, Weiler, Flecken
wein	Wein
weinabasi	Weinbeere
weinagards	Weingarten, Weinberg
weinags	trunken, trunksüchtig, Trunkenbold
weinatains	Weinrebe
weinatriu	Weinstock, Weingarten
weindrugkja	Weintrinker, Säufer
weipan	kränzen, krönen, bekränzen
weis	weise, klug
weis	weis, reihig
weis	wir
weisa	Weise
weisei	Weisheit
weisjan	weisen
weisōn	besuchen, heimsuchen, besorgen
weitan	sehen
weiti	Strafe
weitjan	sehen
weitwōdei	Zeugnis, Bezeugung, Zeugnisablegung
weitwōdeins	Zeugnisablegung, Zeugnis
weitwōdi	Zeugnis
weitwōdiþa	Zeugnisablegung, Zeugnis
weitwōdjan	zeugen, bezeugen
weitwōþs	Zeuge
wēniggō	erwartet
wēnjan	warten, hoffen auf, meinen
wēns	Hoffnung
wēpn	Waffe
wēreis	wahr
wērjan	wahren
wērjands	gewährleistend
wēsei	Sein
wida	Binde
wīda	Weite
widan	binden
wīds	weit
widus	Holz, Wald
widuwaírna	Waise
widuwō	Witwe
wigadeinō	Dornpflanze, Distel
wigan	Kampf
wigan	bewegen
wigis	weg
wigs	Weg
wigs	Kampf
wīhjan	weihen
wikō	Reihenfolge, Ordnung, Woche
wilja	Wille, Wohlgefallen
wiljahalþei	Parteilichkeit, Zuneigung, Gunst
wiljahalþs	willkürlich
wiljan	wollen
wiljei	Willigkeit
wiltan	wälzen
wilþeis	wild
wilwa	Räuber
wilwan	rauben
windags	windig
windan	winden
windiþa	Windung
winds	Wind
winds	schief
Winiþs	Wende
winja	Weide
winna	Leiden, Leidenschaft
winnan	leiden, Schmerz leiden
winne	Weide, wRune
winnō	Leiden
wins	Freund
wintrus	Winter, Jahr
winþeis	Wind, windig
winþiskaúrō	Worfschaufel
winþjan	streuen
wipja	Kranz
wis	Meeresstille
wīs	weise, klug, erfahren, verständig
wisan	sein, existieren, bleiben
wisan	weilen, bleiben
wisan	sich freuen, schwelgen, schmausen
Wisands	Wisent
Wisigoti	Westgoten
wiss	Bindung
wiss	gebunden
wiss	gewiss
wissei	Wissen
wissi	Wissen
wist	Westen
wista	westlich
wistr	Westen
wistra	westlich
wists	Wesen, Natur
wisus	gut
wit	wir beide
wita	wissend
witains	Sehen
witan	wissen
witan	auf etwas sehen, achtgeben, bewachen, hüten, halten, beobachten
witands	wissend
witi	Wissen
witōdafasteis	Gesetzeskundiger
witōdafasts	gesetzesfest
witōdalaisāreis	Gesetzeslehrer, Schriftgelehrter
witōdalaus	gesetzlos
witōdeigō	gesetzlich, gesetzmäßig
witōþ	Gesetz, Gebot
witōþs	gesetzlich
wits	Verstand
witubni	Kenntnis, Erkenntnis
wituls	klug
wiþōn	schütteln
wiþra	wider, gegen, vor, gegenüber
wiþragaggan	entgegengehen
wiþragamōtjan	begegnen
wiþrawaírþs	gegenüberliegend, entgegengesetzt, im Gegenteil
wiþrus	Widder, Lamm
wizdila	Waid, Waidkraut
wizdils	Waid, Waidkraut
wizneigs	froh
wizns	Nahrung
wizōn	schwelgen
wlaitōn	sich umsehen, umherblicken, spähen
wleitan	sehen
wleizn	Gesicht
wliti	Gesicht
wlits	Angesicht, Ansehen, Gestalt, Aussehen
wlizjan	ins Gesicht schlagen, kasteien
wōkains	Wachen
wōkan	wachen
wōkrs	Ertrag, Frucht, Zins
wōpjan	rufen, krähen, zurufen, schreien, ausrufen, laut rufen
wōþeis	angenehm, süß, lieblich
wōþs	wütend, besessen
wraiqs	krumm, schräg
wraka	Verfolgung
wrakja	Verfolgung
wrakjan	verfolgen
wraks	Verfolger
wranks	verdreht
wratōdus	Reise
wratōn	reisen, gehen
wreitan	ritzen, reißen
wrēkei	Verfolgung
wrēks	verfolgt
wrēþus	Herde
wriggan	drehen, winden
wrikan	verfolgen
wrisqan	Frucht bringen
writs	Strich
wrōhjan	anklagen, beschuldigen
wrōhs	Klage, Anklage
wrōtjan	wühlen
wruggō	Schlinge
wulan	wallen, sieden, um sich greifen
wulfs	Wolf
wulla	Wolle
wullāreis	Tuchwalker
wulþags	herrlich, wunderbar, angesehen
wulþrs	wertvoll
wulþrs	Wert
wulþus	Herrlichkeit
wulwa	Raub
wunan	zufrieden sein
wunands	zufrieden
wundōn	wund machen, geißeln, plagen
wunds	wund
wundufni	Wunde, Geißel, Plage
wunns	Leiden
wunsk	Wunsch
xjb	662
xjq	666
xkg	623
xl	630
xnd	654
z	z, Abkürzung für 7
Zēlōtēs	Eiferer
